arise -- возникать
be -- быть
bear -- выдерживать, носить
beat -- бить
become -- становиться
begin -- начинать(ся)
bend -- гнуть(ся), сгибать(ся)
bind -- связывать
bite -- кусать
bleed -- истекать кровью
blow -- дуть
break -- ломать
breed -- выводить, разводить
bring -- приносить
broadcast -- передавать по радио
build -- строить
burn -- жечь, гореть
burst -- разрываться
buy -- покупать
cast -- бросать, отливать
catch -- ловить, схватывать
choose -- выбирать
cling -- цепляться, прилипать
come -- приходить
cost -- стоить
creep -- ползать
cut -- резать
deal -- иметь дело
dig -- копать
do -- делать
draw -- чертить, тащить
dream -- видеть сны, мечтать
drink -- пить
drive -- везти, гнать
dwell -- обитель
eat -- есть, принимать пищу
fall -- падать
feed -- кормить(ся)
feel -- чувствовать
fight -- бороться, сражаться
find -- находить
flee -- спасаться бегством
fling -- кивать, бросать
fly -- летать
forbid -- запрещать
forget -- забывать
forgive -- прощать
freeze -- замерзать, замораживать
get -- получать, становиться
gild -- золотить
give -- давать
go -- идти, ехать
grind -- точить, молоть
grow -- расти, выращивать
hang -- висеть, вешать
have -- иметь
hear -- слышать
hide -- прятать
hit -- ударять, поражать
hold -- держать
hurt -- повредить, ушибать
keep -- держать, хранить
knit -- вязать
know -- знать
lead -- вести
lean -- прислоняться
leap -- прыгать
learn -- учиться
leave -- оставлять, уезжать
lend -- одалживать
let -- позволять, сдавать внаём
lie -- лежать
light -- зажигать, освещать
lose -- терять
make -- делать, заставлять
mean -- значить, подразумевать
meet -- встречать
mow -- косить
pay -- платить
put -- класть
read -- читать
ride -- ехать верхом
ring -- звонить
rise -- подниматься
run -- бежать
saw -- пилить
say -- говорить, сказать
see -- видеть
seek -- искать
sell -- продавать
send -- посылать
set -- помещать, ставить
sew -- шить
shake -- трясти
shed -- проливать (слёзы)
shine -- светить, сиять
shool -- стрелять
show -- показывать
shrink -- сморщиваться
shut -- закрывать
sing -- петь
sink -- погружаться, тонуть
sit -- сидеть
sleep -- спать
slide -- скользить
smell -- пахнуть, нюхать
sow -- сеять
speak -- говорить
speed -- спешить, ускорять
spell -- произносить по буквам
spend -- тратить
spill -- проливать
spin -- прясть
split -- раскалывать(ся)
spoil -- портить
spread -- распространяться
spring -- прыгать
stand -- стоять
steal -- красть
stick -- приклеивать
sting -- жалить
strike -- ударять, бастовать
strive -- стремиться
swear -- класться, браниться
sweep -- мести
swell -- пухнуть, раздуваться
swim -- плавать
swing -- качаться
take -- брать
teach -- учить, обучать
tear -- рвать
tell -- рассказывать
think -- думать
throw -- бросать
thrust -- толкать
tread -- ступать
understand -- понимать
wake -- будить, просыпаться
wear -- носить
weave -- ткать
weep -- плакать
win -- выигрывать
wind -- заводить, виться
wring -- жать, выжимать
write -- писать
to be disappointed at -- быть разочарованным в чём-то
to be surprised at -- удивляться чему-либо
to prevent from -- мешать, препятствовать что-либо сделать
to consist in -- заключаться в чём-либо (проблема)
to persist in -- упорно продолжать что-то
to results in -- иметь результатом что-то
to spend in -- тратить время на что-то
to be engaged in -- заниматься чем-то
to be interested in -- интересоваться чем-либо
to accuse of -- обвинять в
to approve of -- одобрять что-либо
to hear of -- слышать о
to inform of -- сообщать о
to be afraid of -- бояться чего-либо
to be capable of -- быть способным что-то сделать
to be proud of -- гордиться
to count on -- рассчитывать
to insist on -- настаивать
to object to -- возражать против
to get use to -- привыкакть к
disappointed at -- разочарование в чём-то
surprise at -- удивление
apology for -- извинение
plan for -- план
preparation for -- приготовление
reason for -- причина
experience in -- опыт
interest in -- интерес
skill in -- мастерство
art of -- искусство
chance of -- удобный случай
opportunity of -- возможность
fear of -- страх
habbit of -- привычка
hope of -- надежда
idea of -- идея, мысль
importance of -- важность
intention of -- намерение
means of -- средства
method of -- метод
pleasure of -- удовольствие
necessity of -- необходимость
problem of -- проблема
right of -- право что-то сделать
the right to -- право на образование
way of -- способ, путь
objection to -- возражение
weigh -- взвешивать, весить
weight -- вес, тяжесть, груз
well -- хорошо, очень, добро, здоровый
wet -- мокрый
wet -- мокрый
whatever -- любой; все, что
whether -- ли
whisper -- шепот, шептать
whistle -- свистеть, доносить
whose -- чей
widely -- широко
widow -- вдова
widower -- вдовец
wife -- жена
wild -- дикий, бешеный
wild -- исступленный, безумный
willingly -- охотно
wind -- ветер
windfall -- неожиданная удача
wing -- крыло самолета
wipe -- вытирать
wire -- проволока
wise -- мудрый
withdraw -- брать назад, забирать
wonder -- удивляться
woolen -- шерстяной
worse -- худший (не worst)
wound -- рана
wrap -- обертывать
yard -- двор
yell -- крик, кричать
absent -- отсутствующий (не missed)
accept -- соглашать(ся)
accepted -- принятый
accident -- случай, авария
account -- счет, расчет
ache -- боль (не pain)
achievement -- выполнение, достижение
adjust -- регулировать, приспосабливать
admirable -- замечательный (не wonderful)
admire -- восхищаться
admission -- допуск, вход, прием
admit -- допускать, соглашаться (не agree)
ads -- реклама
adult -- взрослый
advance -- продвижение вперед, успех
adventure -- приключение
advice -- cовет
afford -- позволить себе
aids -- вспомогательные средства
aim -- цель
air -- воздух
aircraft -- самолет
airsick -- страдающий от воздушной болезни
alarm -- тревога
alien -- чужестранец
aloof -- поодаль, вдали, в стороне (l в сере
amaze -- изумлять, поражать
amount -- количество, сумма, составлять (сумм
amuse -- смешить
anger -- гнев
announce -- объявлять
anywhere -- где-нибудь
apart -- в стороне, отдельно (не aside)
apiece -- за штуку, поштучно
apology -- извинение
apparently -- очевидно
appear -- появляться
appointment -- условленная встреча
approve -- одобрять
argue -- спорить
arrange -- приводить в порядок, расставлять
arrest -- арест
art -- искусство
artful -- хитрый, ловкий
ashore -- на берег
aside -- в стороне (не apart)
asleep -- спящий
assume -- допускать
attend -- посещать, обслуживать
attorney -- юрист
audience -- публика
audience -- публика, зрители
avoid -- избегать
awake -- будить
aware -- знающий
away -- прочь$
bacon -- бекон
bag -- сумка
balance -- весы
band -- лента, оркестр, ансамбль (музыкальн
band -- тесьма
bang -- удар
barber -- парикмахер
bare -- голый, обнаженный
barrel -- бочка
bastard -- внебрачный ребенок, ублюдок
bat -- летучая мышь
bath -- ванна
battle -- битва
bay -- залив, бухта
beans -- фасоль
beast -- зверь
beauty -- красота
become -- становиться
bedsheet -- простыня
beef -- говядина
beet -- свекла
beg -- просить, умолять
behave -- вести себя
behaviour -- поведение
behind -- позади
bell -- колокол
belong -- принадлежать
belt -- пояс, ремень
berry -- ягода
beside -- рядом, около (не nearly)
besides -- кроме
beware -- осторожно
bit -- кусочек, немного
bitch -- сука
blanket -- одеяло
blast -- взрыв
bleed -- кровоточить
blind -- слепой, ослепленный
blink -- мигать, мерцать
blond -- блондин
bloody -- кровавый
boat -- лодка, пароход
boiled -- вареный, кипяченый
bond -- связь, узы, оковы
booth -- кабинка
booth -- киоск
bore -- скука (r есть)
borrow -- брать в долг
both -- оба
bow -- поклон
bowl -- миска
brace -- связывать, скреплять
brake -- тормоз
branch -- ветка
brass -- установить
brawl -- уличный скандал
breakfast -- завтрак
breast -- грудь, молочная железа
breath -- дыхание
breathe -- дышать
breathe -- дышать
breed -- порода
brew -- затевать, надвигаться
brief -- краткий
bring -- приносить, приводить
broadcast -- передача по радио
brooch -- брошь
brush -- кисть
bug -- жук
bunch -- связка, пучок
burst -- заливаться, разражаться (гневом, сл
bury -- хоронить
busy -- занятой
buzz -- жужжание
cab -- такси
cabbage -- капуста
cable -- кабель
cage -- клетка
calm -- успокаивать
camp -- лагерь
cap -- шапка
cap -- кепка
care -- заботиться, переживать
carriage -- вагон
carton -- коробка
cartoon -- комикс
case -- чехол, футляр
cash -- наличные деньги
cast -- бросать, кидать (не toss)
castle -- замок$
caution -- осторожность
cave -- пещера
caviar -- икра
celebrate -- праздновать
century -- век
certainly -- конечно
chain -- цепь
chamber -- кабинет
chambermaid -- горничная
charge -- плата, стоимость, взимать плату
chase -- погоня
chasing -- уклоняющийся (-ing)
chat -- беседа, болтовня
chatterbox -- болтунья
cheap -- дешевый
cheer -- настроение
cheer -- утешать
cherry -- вишня
chick -- цыпленок
chief -- шеф, начальник
chin -- подбородок
china -- фарфор
choir -- хор
circumstance -- обстоятельство, условие
citizen -- гражданин
claim -- требовать
claim -- требование
claw -- коготь
clearly -- ясно, очевидно
cliff -- отвесная скала
closet -- чулан
clutch -- когти, лапы, хватка
coach -- автобус, купе
coin -- монета
coincidence -- совпадение
collapse -- крах
collar -- воротник
college -- колледж
come -- приходить, приезжать
compartment -- купе
competition -- соревнование
complaint -- жалоба
complicated -- сложный
comprehensive -- богатый
compulsory -- обязательный
condition -- условие
condole -- соболезновать
confuse -- смущать
congratulate -- поздравлять
consolation -- утешение
consult -- советоваться
contact -- устанавливать связь
contain -- вмещать
contributor -- сотрудник
conveniences -- удобства
convince -- убеждать
cook -- повар
cooperation -- сотрудничество
cord -- шнур
corn -- кукуруза
corner -- угол
cost -- стоить, стоил
cost -- цена, стоимость
cosy -- уютный
cotton -- хлопок, хлопчатобумажный
couch -- диван (не divan)
cough -- кашель
cough -- кашель
court -- суд
cousin -- двоюродный брат
coverage -- охват, репортаж
credit -- доверие
creep -- ползать
crew -- судовая команда, экипаж
crime -- преступление
cross -- пересекать
crouch -- присесть
crystal -- хрусталь
curse -- проклятие
curtain -- занавеска
curve -- кривая
customer -- клиент
damage -- вред
danger -- опасность
dangerous -- опасный
dawn -- рассвет
decision -- решение
demand -- требовать, нуждаться
department -- отдел
design -- замысел
destroy -- разрушать
dial -- циферблат
difference -- разница
difficult -- трудный
direct -- прямой
dirt -- грязь
dirty -- грязный
discover -- узнавать, обнаруживать
display -- показ
dissolve -- растворять(ся)
distant -- отдаленный
dive -- ныряние в воду
dodge -- обман, уловка
doubt -- сомнение, сомневаться
downpayment -- задаток
drawer -- ящик (стола)
dream -- мечтать, видеть сны
dress -- платье, одеваться
dressing -- приправа
drugstore -- аптека (не chemist's)
drunk -- пьяный
duck -- утка
due -- должный, обязанный
dull -- скучный (не bore)
dump -- свалка
during -- во время
duty -- пошлина
dyed -- крашенный
eager -- нетерпеливый
earache -- боль в ухе
earrings -- серьги
earth -- земля
ease -- покой (не rest)
echo -- эхо
effort -- попытка
embarrass -- смущать(ся)
emerge -- появляться
emergency -- крайняя необходимость
employer -- работодатель
enemy -- враг
engaged -- занятый, помолвленный
enormous -- громадный
enough -- достаточный
entertainment -- развлечение
enthusiastic -- восторженный
envelope -- конверт
envelope -- обертывать, окутывать
equipment -- снаряжение, оборудование
equipment -- оборудование
especially -- особенно
even -- даже
event -- событие
ever -- когда-либо
everywhere -- везде
evidence -- свидетельство, доказательство, улик
evil -- зло, вред
examine -- рассматривать, исследовать (не test
exchange -- обмен
excite -- возбуждать
exciting -- волнующий, великолепный
exhibition -- выставка
exist -- существовать
expense -- расход
expensive -- дорогой
experience -- опыт
experience -- опыт
explain -- объяснять
explode -- взрывать(ся)
explosion -- взрыв
extend -- простираться
external -- наружный
fail -- неудача, провал
faint -- слабый
fair -- любезно, хорошо, справедливый
fairly -- довольно (не rather)
fairy -- волшебный
faith -- вера
familiar -- знакомый
famous -- известный
fancy -- воображать, представлять себе
fare -- плата за проезд
farther -- дальше
fat -- жир, сало
fault -- вина, недостаток, ошибка
favour -- одолжение, услуга, польза
favour -- благосклонность, одобрение
feather -- предмет гордости, достижение
feature -- особенность
feel -- чувствовать
fell -- упал (от fall)
fellow -- приятель
female -- женский, женщина
fence -- забор
fever -- жар, лихорадка
few -- мало
fiction -- беллетристика, вымысел
fiddlesticks -- вздор
fight -- бороться, бой
fine -- штрафовать
fist -- кулак
fit -- подходить, соответствовать, устраив
fitting -- примерка
fix -- починить, наладить, назначить
flabbergasted -- поражен, изумлен
flashlight -- карманный фонарь
flesh -- тело, плоть
flicker -- мерцание
flip -- щелчок, легкий удар
float -- плавать (на поверхности)
flow -- течение
flower -- цветок
fold -- сгиб, изгиб, складка
folk -- народная
follow -- следовать
fond -- пристрастный, любящий
fool -- дурак
footwear -- обувь
forecast -- прогноз
forehead -- лоб
forest -- лес
forever -- вечно
forget -- забыть
forgive -- прощать
fork -- вилка
forth -- вперед, дальше (в пространственном 
fortnight -- две недели
fortune -- удача, счастье
foyer -- фойе
frankly -- откровенно
freight -- груз, грузовой
fresh -- свежий
fried -- жареный (не roast)
frighten -- пугать
fulfil -- выполнить
fun -- шутка, веселье
fun -- шутка, веселье, забава
fur -- мех, шкура
furniture -- мебель
furs -- меха (от fur)
garden -- сад
gargle -- полоскание
gasp -- затрудненное дыхание
gatecrashers -- незваные гости
generosity -- великодушие
giant -- гигант
glad -- радостный, довольный
glare -- ослепительный яркий свет
glitter -- блеск, блестеть
glove -- перчатка
glove -- перчатка
golden -- золотой
gossip -- сплетня
government -- правительство
gracious -- милосердный
grass -- трава
grave -- могила
greet -- приветствовать
greet -- приветствовать, здороваться (именно
grey -- серый
grief -- горе
guest -- гость
guide -- гид, экскурсовод
hairdresser -- парикмахер
hairspray -- лак для волос
ham -- ветчина
handle -- обращаться с, управлять
hardly -- едва
heat -- жара
heaven -- небо
heel -- пятка
helicopter -- вертолет
hesitate -- колебаться, сомневаться, не решатьс
highway -- шоссе
hire -- прокат, наем
hiss -- шипение, свист
honey -- мед
honour -- честь
hood -- капюшон
hook -- крюк, крючок (рыболовный)
horror -- ужас
household -- домашнее хозяйство
hug -- крепко обнимать
humid -- влажный
humidity -- влажность
humorous -- смешной
hunt -- охота
hurry -- спешить, торопиться, спешка
hurt -- рана, болеть, причинить боль, повре
ice -- лед
icebox -- холодильник (морозильник)
impossible -- невозможный
impressive -- впечатляющий
incredible -- невероятно (не impossible)
indeed -- неужели, действительно
indeed -- в самом деле (не really)
indicate -- показывать, указывать
indifference -- безразличие
indigestion -- несварение, расстройство
inevitability -- неизбежность
inferior -- худший, плохой
influence -- влияние, влиять
inquiry -- расспросы, наведение справок
instant -- миг, мгновение
instantly -- немедленно
intelligence -- ум
intention -- намерение
interior -- внутренняя часть
interrogative -- вопросительный
introduce -- предстaвлять, знакомить
involve -- вовлекать
iron -- железо
irritation -- раздражение
issue -- выпуск, издание, выпускать
jam -- варенье, джем
jam -- затор, давка
jerk -- резкое движение, толчок
joke -- шутка
jolly -- очень, веселый
journey -- путешествие
joy -- радость
jumper -- джемпер
jungle -- джунгли
junior -- младший
justice -- справедливость
keen -- страстный
keep -- (со)держать, сохранять
keepsake -- подарок, сувенир на память
kidney -- почка (анатом.)
kneel -- стоять на коленях
lake -- озеро
lamp -- лампа
laugh -- смех
leader -- лидер
leather -- выделанная кожа
lettuce -- салат
library -- библиотека
lifeboat -- спасательная лодка
linen -- белье
liquid -- жидкость
list -- список
litter -- мусор, сорить
liver -- печень
lobby -- приемная, фойе
lot -- много
lovely -- прекрасный, восхитительный
luck -- удача, везение
luck -- удача
lucky -- счастливый (не happy)
luggage -- багаж
lunch -- ленч
luxurious -- роскошный
mad -- обезумевший
mad -- сумасшедший
magazine -- журнал
maid -- горничная
male -- самец
map -- карта
market -- рынок
married -- женатый, замужняя
mascara -- тушь
mass -- масса
mess -- беспорядок, путаница
military -- военный
mill -- мельница
miss -- потеря, утрата
monster -- чудовище
moot -- спорный
murmur -- шепот
muscle -- мышца
mushroom -- гриб
mustard -- горчица
mutter -- бормотать
nail -- ноготь, гвоздь
nail -- гвоздь
naked -- голый, обнаженный (окончание -ed)
nasty -- скверный, плохой
nature -- природа
nearby -- близлежащий, соседний
necessary -- необходимый
necklace -- ожерелье
never -- никогда
noodle -- лапша, балда
nor -- не, также не
nuisance -- досада
nuke -- грохнуть, преднамеренно убить (не k
nursery -- детский, ясли
nut -- орех
oblige -- обязывать
observe -- наблюдать
obvious -- очевидный, явный
obviously -- очевидно
occupation -- занятие
occur -- случаться, происходить
odd -- странный
odd -- нечетный
offer -- предлагать
often -- часто
oil -- масло
opposite -- противоположный
ought -- следовало бы
ounce -- унция
outlet -- выход, выходное отверстие
overdrawn -- преувеличенный, превышенный
overdue -- запоздалый
overjoyed -- вне себя от радости, очень довольны
overtime -- сверхурочные
own -- иметь, владеть, свой, собственный
oyster -- устрица
pace -- шаг (не step)
pad -- подушка
palm -- ладонь
pants -- трусы
parcel -- посылка, бандероль
parlour -- кабинет (не chamber)
parrot -- попугай
particular -- редкий, особенный
pat -- похлопывание, шлепанье
patient -- терпеливый
pattern -- образец
pay -- платить, зарплата
payment -- плата
peace -- мир
peach -- персик
pear -- груша
pearl -- жемчуг, жемчужный
peas -- горошек, горох
pension -- пенсия
perfectly -- совершенно
perform -- делать, выполнять
performance -- спектакль
perfume -- духи
perhaps -- возможно, может быть
permanent -- постоянный
permission -- разрешение
permit -- разрешать
personal -- личный
pie -- пирог
piece -- кусок
pile -- куча
pill -- таблетка, пилюля
pillow -- подушка
pin -- булавка
pink -- розовый
pipe -- труба, трубопровод
pistol -- пистолет
pitch -- бросок, подача
plain -- плоский, ровный
plant -- завод
pleasure -- удовольствие
pool -- бассейн
porch -- крыльцо
possibly -- возможно (не probably), окончание "
powerful -- мощный
presence -- присутствие
pressure -- давление
pretend -- притворяться
priest -- священник
prison -- тюрьма
prisoner -- заключенный
prohibit -- запрещать
promise -- обещать
pronouns -- местоимения
proposal -- предложение
propose -- предлагать (не suggest)
protect -- защищать
prove -- доказывать, подтверждать
pull -- тянуть, тащить
pump -- насос
punch -- удар кулаком
purpose -- цель, намерение
puzzle -- головоломка
quarter -- четверть, квартал (четверть года)
quite -- вполне, совсем
rabbit -- кролик
racket -- ракетка
rage -- гнев, ярость
rail -- перила
range -- диапазон
rare -- редкий, недожаренный
rat -- крыса
react -- реагировать
receive -- получать
refuse -- отвергать
regard -- внимание, забота
relax -- расслаблять(ся)
release -- освобождать, выпускать
remind -- напоминать
replace -- заменять
reporter -- докладчик
reserve -- запас
respect -- уважение
respond -- реагировать
response -- ответ
responsibility -- ответственность
rich -- богатый, плодородный
ring -- кольцо, звон, звонок, звенеть, звон
risk -- риск
roar -- реветь, орать, хохотать
roast -- жареный (не fried)
robbery -- грабеж
rope -- веревка
rough -- грубый
rub -- трение, стирание
sake -- ради чего-либо
sand -- песок
scar -- шрам
scarf -- шарф
schedule -- расписание, таблица, планировать
scratch -- царапина
scream -- вскрикнуть, зареветь, визг, вопль
screw -- винт, болт
script -- сценарий
seal -- печать
seaside -- морское побережье (не coastal)
seek -- искать
separate -- отдельный
serve -- служить
shatter -- разбить вдребезги
shelf -- полка
shell -- оболочка
shindy -- шум, скандал
shine -- сиять, блестеть
shot -- попытка, выстрел
shotgun -- дробовик
shoulder -- плечо, толкать
shove -- толчок ("ov" в середине)
shower -- душ, ливень
shower -- ливень
shrimp -- креветка
sick -- больной (не pain,ache)
sidewalk -- тротуар
silent -- безмолвный
silver -- серебро
sip -- пить маленькими глотками
site -- место, участок
skull -- череп
slight -- стройный, тонкий
smash -- катастрофа (не crash)
smoke -- дым
smooth -- гладкий, ровный
snake -- змея
somehow -- как-нибудь, так или иначе
song -- песня
soul -- душа
split -- раскалывание
stack -- куча
startle -- испуг, страх
steady -- твердый, устойчивый
steam -- пар
stir -- шевеление
stomach -- желудок
strain -- натяжение, растяжение
stranger -- незнакомец
stream -- поток, течение
strength -- сила
stride -- большой шаг
strip -- полоса
stumble -- спотыкание
stun -- оглушать
subject -- тема
suck -- сосать
suggest -- предлагать
supply -- снабжать
support -- поддержка
surround -- окружать
survive -- выжить
suspect -- подозревать
swallow -- глоток
swear -- клятва
sweet -- сладкий
swell -- раздуваться
tag -- бирка, ярлык
tail -- конец, хвост
tail -- хвост
tale -- повесть, сказка, история
tall -- невероятный, высокий
tall story -- небылица (2 слова)
tap -- водопроводный (газовый) кран
target -- мишень
taste -- пробовать, иметь вкус
taste -- вкус
temple -- храм
terrible -- страшный
terrify -- вселять ужас
thumb -- большой палец (руки)
tip -- кончик (тонкий конец (пальца))
tongue -- язык
totally -- полностью, совершенно
tough -- жесткий
towel -- полотенце
trace -- след (не trail)
traffic -- движение транспорта
trail -- след (не trace)
trap -- капкан, ловушка
treat -- угощение
tremble -- дрожать
trick -- обман, хитрость
trunk -- ствол (дерева)
twice -- дважды
uncle -- дядя
universe -- вселенная
unless -- если не; пока не
upset -- опрокидывать, переворачивать
upstairs -- вверх (по лестнице)
usually -- обычно
van -- фургон
vanish -- исчезать
various -- различный
vehicle -- транспортное средство
victim -- жертва
village -- деревня
vinegar -- уксус
violin -- скрипка
visible -- видимый
vivid -- живой, яркий
volume -- объем, громкость
waiter -- официант
wake -- будить, просыпаться
wander -- бродить, скитаться
wash -- мыть(ся)
waste -- тратить , использованный, негодный
waste -- бесполезная трата
weight -- вес
weird -- таинственный
whip -- кнут
whistle -- свист
witness -- свидетель, очевидец
wonderful -- удивительный
wooden -- деревянный
worse -- хуже (от bad)
worth -- цена (не price)
wrist -- запястье
wrong -- неправильный, не тот
youth -- молодежь
abundance -- богатство, изобилие
accidentally -- случайно, нечаянно
acknowledge -- признавать, вознаграждать
acquaintance -- знакомство, знакомый
across -- через
admit -- допускать
affability -- любезность, вежливость
after all -- в конце концов (2 слова)
aggrieve -- обижать, огорчать
angry -- сердитый
anyway -- в любом случае
backward -- назад, обратно, наоборот
banner -- знамя
barely -- только, едва, лишь
bend -- гнуться, сгибаться
beneath -- ниже, внизу
blade -- лезвие
burst -- взрываться, лопаться
calm -- тихий, успокаивать
colonel -- полковник
concern -- отношение, иметь отношение (к) (не 
couple -- пара, два
crack -- треск
cruel -- жестокий, беспощадный
cruelty -- жестокость
cure -- лекарство, лечить (не drug)
currency -- валюта
curve -- изгиб, гнуть
cute -- изящный, прелестный
damp -- сырой, влажный
debt -- долг
decent -- приличный, скромный
departure -- отъезд, отправление
direct -- прямой, руководить
disappoint -- разочаровывать
discuss -- обсуждать
discussion -- беседа
embassy -- посольство
emergency -- крайняя необходимость
escape -- побег
exhausted -- изнуренный
exile -- ссылать, изгнание
expectancy -- ожидание, надежда
fabric -- ткань, материя, сооружение
faint -- слабый
faith -- вера
faithless -- ненадежный
frown -- хмуриться
ghost -- призрак, привидение
glow -- свет, сверкать
handle -- ручка, рукоятка, удобный случай, во
hope -- надеяться
hose -- чулки
ignorance -- незнание, невежество
income -- доход, заработок
incomprehension -- непонимание
lark -- шутка, забава (не joke)
leather -- кожа, кожаный
matinees -- утренние спектакли
matter -- дело, сущность, материал
meal -- еда, есть, принимать пищу
means -- средство, способ
mend -- чинить, ремонтировать
mention -- благодарность, упоминать
mild -- мягкий (не soft)
mistrust -- недоверие, подозрение
nearly -- почти, около (не almost)
oar -- весло
ointment -- мазь
pity -- жалость
place -- место
plain -- ясный, очевидный, равнина
plane -- плоскость, самолет
pleasant -- приятный
pocket -- карман, мешок
polite -- любезный, вежливый
pool -- пруд, бассейн
prescription -- рецепт
private -- рядовой
quarrel -- ссора, ссориться
questionable -- сомнительный
quiet -- спокойный (не still)
quite -- вполне, совсем
rather -- скорее, лучше
receipt -- квитанция
reception -- прием
reference -- рекомендация, ссылка, справка
rely -- полагаться, доверять
rent -- брать напрокат, снимать жилье, квар
respect -- уважение, уважать
rip -- разрез, разрыв
rot -- вздор, нелепость
rowing -- гребля, выговор
rush -- спешка, бросаться
sauce -- соус, приправа, поливать соусом
scare -- пугать
shake -- пожать (руки), дрожать, трясти
share -- разделять, доля, часть
sharp -- точно, ровно, резкий, крутой, плуто
shot -- выстрел
silence -- молчание, тишина
silly -- глупый
slam -- со стуком (шумом) закрыть, захлопну
slumber -- сон, дремота, дремать
snack -- закуска
snap -- треск
soap -- мыло
spare -- уделять, лишний, запасный
spin -- вертеться, вращение
splendid -- замечательно
spoon -- ложка
stair -- ступенька
stocking -- чулок
straight -- прямой, честный
stroll -- прогулка, гулять
suggest -- предлагать, советовать
suitable -- подходящий, соответствующий (не eli
superb -- превосходный
supper -- ужин
surrender -- сдаваться, уступать
swell -- отличный, превосходный
swing -- качание, качели, качаться, колебать
tablet -- таблетка
tack -- линия, курс
team -- команда
teeth -- зубы
temper -- сдержанность, самообладание
textiles -- ткани
thick -- толстый, густой
thirsty -- испытывающий жажду
thought -- мысль, размышление
tidy -- чистый, аккуратный, убирать, привод
tight -- плотный, крепкий, тугой
till -- до
toothache -- зубная боль
toss -- бросать
toss -- толчок, сотрясение, кидать, бросать
tough -- жесткий
twist -- изгиб, вертеться
utter -- издавать (звук), произносить
veal -- телятина 
vexed -- сердил, раздражал
weapon -- оружие
weekend -- выходные
willingly -- охотно
wing -- крыло самолета
wipe -- вытирать
wonder -- удивляться
worse -- худший (не worst)
yard -- двор
yell -- крик, кричать
ample -- обширный, просторный
amplify -- увеличивать, усиливать
anew -- снова, заново
animate -- оживлять, вдохновлять
anniversary -- годовщина
announcer -- диктор
anxiety -- тревога, беспокойство
ape -- обезьяна
apparent -- видимый, очевидный
justice -- справедливость
justly -- справедливо
lead -- вести, руководить
lid -- крышка
lively -- живой, оживленный
loaf -- безделье
mankind -- человечество
marble -- мрамор
mat -- коврик
mate -- товарищ
meadow -- луг
meanwhile -- тем временем, между тем
nest -- гнездо
nevertheless -- тем не менее
opportunity -- возможность
oppressive -- гнетущий, деспотический
oral -- устный
orchard -- фруктовый сад
origin -- происхождение
otherwise -- иначе
outlaw -- человек вне закона, изгнанник
plea -- оправдание, довод
plenty -- изобилие, избыток, вполне, довольно
plume -- перо
pocket -- карман
sorrow -- печаль
sow -- сеять
spacious -- просторный, обширный
spark -- искра
thief -- вор
thirst -- жажда
tribe -- племя, клан
troops -- войска
trumpet -- труба
trunk -- ствол, туловище
tube -- труба (не pipe)
tumble -- падать, опрокидываться
tune -- мотив
unconscious -- бессознательный
ambition -- честолюбие, желание
among -- среди
amorous -- влюбленный, любовный
appeal -- воззвание, взывать
appearance -- появление, внешность
applaud -- аплодировать
applause -- аплодисменты
appoint -- назначать
leadership -- руководство
leaf -- лист
lean -- прислоняться, наклоняться, наклон
least -- наименьший, менее всего
liar -- лгун
loud -- громкий
loyal -- верный, лояльный
loyalty -- верность
magnificent -- великолепный
pine -- сосна
playbill -- афиша
playground -- площадка для игр
playmate -- товарищ
playwright -- драматург
sparrow -- воробей
speaker -- оратор
speech -- речь
spirit -- дух
spit -- плеваться, фыркать
spoil -- портить, баловать
stable -- конюшня
staff -- штат, персонал, штаб
stare -- пристальный взгляд
startle -- испугать, сильно удивить
starvation -- голод, голодание
starve -- умирать от голода
though -- хотя, несмотря на
threat -- угроза
threaten -- грозить, угрожать
thrive -- преуспевать, буйно, пышно расти
throb -- пульсация, пульсировать
throughout -- повсюду, везде, во всех отношениях
thunder -- гром, греметь
thus -- так, таким образом
timber -- бревно
timid -- робкий, застенчивый
tin -- консервная банка
undertake -- предпринимать
abandon -- оставлять, покидать
ability -- способность (не capable)
aboard -- на борту
abruptly -- внезапно, резко, грубо
accompany -- сопровождать
according -- согласно
adjust -- приспосабливать
admire -- восхищаться
affair -- дело
afford -- позволять себе, иметь возможность
aisle -- проход между рядами (в театре)
alert -- тревога (не alarm)
alongside -- рядом
alright -- удовлетворительный (не satisfy)
amber -- янтарь
ambulance -- машина скорой помощи
amount -- количество, сумма
amuse -- развлекать
anger -- гнев
angrily -- сердито
ankle -- лодыжка, щиколотка
announce -- объявлять
annoy -- надоедать, раздражать
anxious -- озабоченный, беспокоящийся
apply -- применять, использовать, употреблят
appreciate -- ценить
armor -- бронь
arrive -- прибывать
arrow -- стрела
article -- статья
ash -- зола, пепел
assassin -- наемный убийца
assault -- нападение, штурм
asshole -- задница
assume -- допускать
assure -- убеждать
attach -- прикреплять
attendant -- служитор
attitude -- позиция, отношение
attractive -- привлекательный
awful -- ужасный
bandage -- бинт
bare -- голый, обнаженный
bark -- лаять
bartender -- бармен
basement -- основание, подвал
batter -- сильно бить, колотить
bay -- залив, бухта
bean -- боб
beard -- борода
become -- становиться
beg -- просить, умолять
believe -- верить
bell -- колокол
belly -- живот
beneath -- под, ниже, внизу
bet -- держать пари
bind -- вязать, связывать, привязывать
bit -- кусочек, немного
bite -- кусаться, жалить
bitter -- горький
blade -- лезвие
blame -- вина (не guilt, fault)
blank -- пустой (не empty)
blanket -- одеяло
blaze -- яркий огонь, пламя, адский огонь
bless -- благословлять
blind -- слепой, штора
blink -- мигать
blur -- затуманивать
bolt -- засов
bone -- останки
boom -- гул, рокот, бум (не roar)
bore -- скука (не dull)
bounce -- вскакивать
brand -- сорт, качество
breast -- грудь
breath -- дыхание, вздох
breathing -- дыхание
breeze -- легкий ветерок
brick -- кирпич
bride -- невеста
brief -- краткий
briefcase -- портфель
briefly -- кратко
brilliant -- блестящий
broad -- широкий
bruise -- синяк
bubble -- пузырь
buck -- доллар
bud -- приятель (не pal)
bullshit -- ерунда (не nonsense)
bump -- столкновение, врезаться
bureau -- бюро, комитет
bush -- куст
bust -- неудачник, изгой
cabinet -- сервант, шкаф
calmly -- тихо, спокойно
career -- карьера
cargo -- груз
carpet -- ковер
carry -- нести, везти
cart -- телега
carve -- вырезать (из дерева)
casually -- случайно
cautiously -- осторожно
champagne -- шампанское
chaos -- хаос
cheap -- дешево
chew -- жвачка
chili -- острый перец
chill -- простуда
chip -- щепка, стружка
choke -- удушье
chop -- рубить
chopper -- нож мясника
chuckle -- хихикать
chunk -- ломоть (хлеба, сыра)
circumstance -- обстоятельство
citizen -- гражданин
clay -- глина
cling -- цепляться, прилипать
clip -- зажим, скрепка
closely -- близко
cockpit -- кабина (в самолете)
coffin -- гроб
collar -- воротник, ожерелье
column -- колонна, столбец
commit -- совершать (обычно дурное)
complain -- жаловаться, выражать недовольство
conceal -- скрывать
confidence -- доверие
conscious -- сознающий, понимающий
consider -- полагать, считать
console -- утешать
cord -- шнур, веревка
corpse -- труп
couch -- диван (не divan)
county -- округ (не окрестности)
courtyard -- внутренний двор
crack -- треск, трещать
craft -- ремесло
crane -- журавль
crap -- чепуха, дерьмо (не shit, fuck)
crate -- ящик, контейнер
cream -- сливки
crime -- преступление
crush -- раздавить
cuff -- наручники
curb -- обочина тротуара
curl -- локон, завиток
custom -- обычай
cute -- умный
dangle -- свободно висеть
dare -- сметь, отваживаться
darken -- затемнять
dart -- дротик
dash -- сшибать с ног
dealer -- коммерсант
debris -- обломки, развалины
deck -- палуба
deeply -- глубоко
defeat -- поражение
defense -- оборона
deny -- отрицать
depend -- зависеть
descend -- спускаться
deserve -- заслуживать
desperate -- безнадежный
desperately -- отчаянно
despite -- несмотря на, вопреки
devil -- дьявол, черт
dial -- циферблат
dim -- тусклый
disgust -- отвращение, раздражение
dish -- блюдо
disturb -- беспокоить, мешать
divorce -- развод
doll -- кукла
downstairs -- вниз (по лестнице)
downtown -- деловой район
downward -- спускающийся
dragon -- дракон
drain -- водосток, канализация
drift -- дрейф
drill -- сверло
drip -- капать
driveway -- проезд
drum -- барабан
dude -- парень
due -- должный, обязанный
dull -- скучный (не bore)
dumb -- немой
dusk -- сумерки
earn -- зарабатывать
easily -- легко, без труда
embrace -- объятия
engage -- нанимать, заниматься
enough -- достаточно
escape -- побег
escort -- сопровождение
establish -- учреждать
eventually -- в конце концов
ever -- когда-либо
excitement -- возбуждение
exhaust -- истощать, изнурять
expensive -- дорогой
explanation -- объяснение
expose -- выставлять
exterior -- внешность (человека)
extra -- дополнительный
eyebrow -- бровь
fairly -- справедливо
fake -- подделка
familiar -- знакомый
famous -- знаменитый
fan -- вентилятор
farm -- ферма
fat -- жир, жирный, толстый
fault -- ошибка, вина (не guilt, blame)
filter -- фильтр
firmly -- твердо, крепко (не steady)
fit -- годный
flee -- убегать
fleet -- флот
flick -- щелчок (не click)
flicker -- мерцание
flight -- полет, рейс
fling -- бросать, швырять (не throw)
flip -- легкий удар
flood -- наводнение
flush -- румянец, покраснеть
fog -- туман
fold -- складка
former -- бывший
frantically -- неистово
freak -- каприз
freedom -- свобода (не liberty)
fry -- жарить
fuel -- топливо
fumble -- неумело обращаться с чем-либо
funeral -- похороны
fur -- мех
gain -- прибыль, выигрыш
gale -- шторм
garbage -- мусор (не rubbish)
gear -- механизм
gene -- ген
gift -- подарок
gin -- джин
ginger -- приподнятое настроение
gleam -- слабый свет
glimpse -- мелькание, мельком взглянуть
glove -- перчатка
gonna -- собираться что-либо сделать
gotta -- должен, должна (разговорное)
grace -- грация
grasp -- схватить, понять
grind -- молоть, толочь, зубрить
grip -- сжатие, хватка
groan -- стон, стонать
growl -- рычать, ворчать, огрызаться (не gru
grunt -- хрюкать, ворчать
guilty -- виноватый (не faulty, blamed)
gut -- кишка
halfway -- на полпути
handkerchief -- носовой платок
harbour -- гавань
harm -- вред, ущерб
hat -- шляпа
hatch -- люк
haul -- буксировать
hawk -- ястреб
headlight -- автомобильная фара
headquarters -- штаб
helmet -- шлем, каска
hick -- провинциал, деревенщина
hint -- намекать
hip -- бедро
hollow -- пустота
holy -- святой, священный
homicide -- убийца, убийство (не murderer)
hood -- капюшон, чехол, капот
hook -- крюк
hop -- прыжок, прыгать
horizon -- горизонт
horn -- рог
horrible -- ужасный (не terrible)
horrify -- ужасать (не terrify)
hover -- парить
howl -- вой, выть
huddle -- группа, кучка, скопление
hull -- кожура (не peel)
hum -- жужжание
hunch -- горб
hunt -- охотиться
hurl -- швырять (не сбивать с ног)
hush -- тишина (не calm)
hut -- хижина
ill -- больной
illuminate -- освещать
impact -- удар, столкновение
impress -- производить впечатление
impression -- впечатление
incredible -- невероятный (не impossible)
insurance -- страхование
intend -- намереваться
intense -- интенсивный
investigation -- расследование, изучение
issue -- издание, выпуск
item -- пункт, параграф, статья
jail -- тюрьма
jar -- резкий звук, ссора
jaw -- пасть
jeep -- джип
jerk -- резкое движение
joint -- место соединения
joker -- шутник
journey -- поездка, путешествие
jury -- присяжные
knot -- узел
lack -- недостаток
lad -- парень (не guy)
ladder -- лестница
lake -- озеро
lane -- узкая дорожка
lap -- колени
laughter -- смех
launch -- начинать, запускать
lawn -- газон, лужайка
least -- наименьший
lick -- лизать
lid -- крышка, веко
lighter -- зажигалка
lightning -- молния
limb -- конечность (руки, ноги)
limp -- хромать (не lame)
link -- звено, связь
liquid -- жидкость
lobby -- прихожая
locate -- определять местоположение
log -- бревно, чурбан
lone -- одинокий
lonely -- одинокий
loom -- неясные очертания
lose -- терять
loudly -- громко
lounge -- гостиная, холл
luck -- удача, счастье
lung -- легкое (анатомия)
maintain -- поддерживать
marine -- морской пехотинец
market -- рынок
marry -- жениться (выходить замуж)
meal -- принятие пищи
mean -- значить; подразумевать
meanwhile -- тем временем
melt -- таять
mental -- умственный
merely -- только, просто
midnight -- полночь
mist -- легкий туман, дымка
moan -- стон, стонать
mob -- толпа
mood -- настроение
mount -- холм, гора
movement -- движение
mud -- грязь
mumble -- бормотать (не mutter)
mystery -- тайна
nasty -- омерзительный
navy -- военно-морской флот
nut -- орех
occasion -- случай, событие, повод
occasionally -- время от времени
occupy -- занимать (место, должность)
operate -- работать, действовать, управлять
opinion -- мнение
opportunity -- благоприятная возможность
otherwise -- иначе
outer -- внешний, наружный
overlook -- смотреть сверху
owe -- задолжать
pace -- шаг (не step)
pack -- пакет, тюк
paint -- краска
pair -- пара
pal -- приятель, товарищ (не bud)
particularly -- особенно
party -- вечеринка
pass -- проходить, проезжать; выдержать (эк
patch -- заплатка
patient -- терпеливый
patrol -- патруль
pavement -- тротуар (не sidewalk)
peace -- мир, покой
peek -- быстрый взгляд, взгляд украдкой
peel -- кожура, корка (не hull)
peer -- всматриваться
perform -- выполнять
permit -- разрешать
personally -- лично, сам
pierce -- прокалывать, пронзать
pillow -- подушка
pin -- булавка
pit -- яма
plead -- просить, умолять
plenty -- изобилие
plunge -- нырять, окунаться
poison -- яд
poke -- совать, пехать
pole -- столб
pop -- хлопнуть, треснуть
pose -- поза
possess -- владеть, обладать
pot -- горшок, кастрюля
pray -- молиться, умолять
prefer -- предпочитать
pretend -- притворяться
prevent -- предотвращать, мешать
pride -- гордость
probe -- зондировать
proceed -- продолжать
proof -- доказательство (не prove)
prop -- подпирать
property -- собственность
proud -- гордый
pure -- чистый, без примеси
purse -- кошелек, дамская сумочка
puzzle -- вопрос, ставящий в тупик
race -- гонки
rack -- вешалка
rag -- тряпка
ramp -- идти под уклон
rank -- шеренга
rape -- изнасилование
rate -- расценка
rattle -- треск, грохот
reality -- действительность
receiver -- получатель
recover -- получать обратно, выздоравливать
reflect -- отражать(ся)
regret -- сожаление
regular -- обычный
relieve -- облегчать, освобождать
represent -- представлять
request -- просьба
rescue -- спасение (жизни)
resist -- сопротивляться
resume -- возобновлять
retire -- оставлять должность
retreat -- отступление
reveal -- разоблачать, обнаруживать
reverse -- противоположное, обратное
rib -- ребро (не бедро!)
rid -- избавлять(ся)
rig -- оснащать
roadside -- обочина дороги
rob -- грабить
robe -- халат
rocky -- скалистый
rod -- прут, стержень, розга
roll -- рулон
route -- маршрут
rubber -- резина, резинка
rumble -- грохот, греметь
rumour -- слух
sack -- мешок
sailor -- моряк, матрос
scale -- весы
scatter -- разбрасывать
scientist -- ученый
score -- счет (в игре)
scramble -- карабкаться
scrape -- скоблить, скрести
screech -- визжать
screenplay -- сценарий
seize -- хватать, схватить (не grasp, catch)
sentence -- приговор, предложение
sequence -- последовательность
shaft -- древко, ручка, рукоятка, черенок
shame -- стыд, позор
sharply -- резко
shave -- бриться
shed -- сарай
shelter -- приют
shepherd -- пастух
shield -- щит
shift -- смена
shiver -- дрожать, трястись
shove -- толчок
shower -- душ, ливень
shriek -- визжать, вопить
shudder -- дрожь (не tremble)
silhouette -- силуэт
silk -- шелк
skill -- мастерство
skip -- пропускать (часто бывает при устано
skirt -- юбка
slam -- со стуком (шумом) закрыть, захлопну
slap -- хлопать, шлепать
slave -- раб
sleeve -- рукав
slice -- ломтик (хлеба)
slide -- скользить
slightly -- слегка, едва
slope -- уклон, откос
slug -- тунеядец
slump -- резко падать
smooth -- гладкий, ровный
snarl -- рычать
snatch -- хватка
sneak -- подлец
sniff -- фыркать (не snort)
snort -- фыркать (не sniff)
soak -- пропитывать
sob -- рыдание
social -- общественный
sour -- кислый
sour cream -- сметана (2 слова)
spare -- запасной
spark -- искра
speaker -- оратор
spell -- произносить по буквам
spider -- паук
spike -- острие
spill -- проливать(ся)
spin -- вращение
spirit -- душа, натура
spit -- плеваться, моросить
splash -- брызги
sprawl -- развалиться (на кресле)
spy -- шпион
squad -- группа, команда
squeeze -- сжимать, протискиваться
squint -- смотреть украдкой, косить
stab -- колотая рана, наносить удар холодны
staff -- штат, штаб
stagger -- шататься
stain -- пачкаться, позорить
staircase -- лестница
stall -- стойло, конюшня, ларек
stamp -- топот
starling -- скворец
statement -- заявление, утверждение
stay -- пребывание, оставаться
steal -- красть
steam -- пар
steer -- управлять (автомобилем)
stern -- строгий
stiff -- тугой, упрямый, непоколебимый (не t
sting -- жало
stir -- шевелиться
straight -- прямой, честный, прямо, немедленно
strain -- натяжение, напряжение
strap -- ремень
streak -- полоска (не stripe)
stroke -- удар, взмах
stun -- оглушать
such -- такой
sue -- судиться
suicide -- самоубийство
suitcase -- чемодан
suite -- номер-люкс
suspect -- подозревать
suspicious -- подозрительный
swarm -- толпа (не crowd)
sway -- качать(ся)
sweep -- мести
swirl -- водоворот
sword -- меч
tan -- загар
tangle -- путаница
technician -- техник
tension -- напряжение
tent -- палатка
term -- срок
terminal -- конец
therefore -- поэтому
thought -- мысль
threat -- угроза
threaten -- угрожать
throughout -- через, повсюду
thrust -- толчок
thumb -- большой палец (руки)
thump -- тяжелый удар
tie -- соединение, галстук
tight -- туго
tighten -- сжимать(ся) (не squeeze)
tile -- черепица
tilt -- наклон
toe -- палец ноги
torch -- факел
torture -- пытать
tour -- обращение, оборот, цикл
trace -- след (не trail, track)
track -- след (не trace, trail)
trail -- след (не trace, track)
trailer -- прицеп
transfer -- перемещение
trash -- хлам
tray -- поднос
treasure -- сокровище
trick -- обман, трюк (не dodge)
trigger -- защелка, спусковой крючок
troop -- группа людей, отряд
trooper -- солдат любого вида войск (не warrio
trouble -- заботы, беспокойство
tube -- труба (не pipe)
tuck -- прятать
tug -- тянуть с усилием
tumble -- упасть
tune -- мелодия, настраивать
twin -- близнец
ugly -- уродливый
unable -- неспособный
underneath -- под, внизу, снизу
uniform -- форменная одежда
united -- соединенный (не от слова join)
unusual -- необыкновенный
upset -- расстроенный
upward -- направленный вверх
urge -- побуждение, толчок
vast -- обширный, громадный
violently -- неистово, яростно
visitor -- посетитель
wade -- брод
wagon -- повозка
wail -- вопль, вой
waist -- талия
waitress -- официантка
wallet -- бумажник
warehouse -- товарный склад
warrior -- воин (не trooper)
weak -- слабый
wedding -- свадьба
weekend -- выходные (не holiday)
weep -- плакать
whale -- кит
whatever -- любой, все что
whenever -- всякий раз когда; когда бы ни
whether -- ли
whoever -- кто бы ни, любой
whom -- кого
willing -- охотно делающий
windshield -- щит от ветра
wink -- мигать, моргать
witch -- ведьма, страшная баба
worth -- стоимость
wreck -- авария (не crash, smash)
zip -- застежка-молния
abide -- ждать, терпеть
aboard -- на корабле, на борту, в вагоне
abolish -- отменять, уничтожать
absurd -- бессмысленный
absurdity -- абсурд
accordion -- баян
accordion -- баян
acquaintance -- знакомство
advance -- аванс
aerial -- антенна
against -- против
agony -- агония
agrarian -- аграрный
aim -- намерение, цель
aimless -- бесцельный
airbase -- авиабаза
alight -- выходить, спускаться
alike -- похожий
alimony -- питание, содержание
alive -- живой
alliance -- союз, родство, общность
alone -- одинокий
along -- по, вперед (по дороге)
aloud -- громко, вслух
alteration -- изменение
altogether -- всего, в общем
amateur -- любитель
ambassador -- посол
amnesty -- амнистия
amply -- обильно, богато
ancient -- древний
angel -- ангел
anticipate -- ускорять, предвосхищать
anxious -- причиняющий беспокойство
appropriate -- подходящий, соттветствующий
arbour -- беседка
arch -- арка
arrest -- арест
asphalt -- асфальт
assign -- назначать
assist -- поддержка, содействие, помощь
attachment -- верность, привязанность
attack -- атака
authority -- авторитет
autonomous -- автономный
autonomy -- автономия
available -- доступный
avoid -- избегать, сторониться
away -- далеко, прочь
badger -- барсук
badger -- барсук
balcony -- балкон
bandage -- бинт
bank -- берег реки, пруда
bankrupt -- банкрот
bankrupt -- банкрот
barren -- бесплодный
barrier -- барьер
barrier -- барьер
basket -- корзина
bathe -- купаться
battle -- битва
be careful -- быть осторожным
beast -- зверь, животное
beat -- бить
because -- потому что
bee -- пчела
beforehand -- заранее
belief -- вера, доверие
believe -- верить
belong -- принадлежать
beloved -- любимый
bench -- скамейка
benefit -- благо, польза
bent -- склонность, наклонность
berth -- койка, спальное место
bet -- держать пари, пари
birch -- береза
blood -- кровь
brief -- краткий
broad -- широкий
broom -- метла, мести
brutal -- грубый, жестокий (не severe)
bulk -- груз, величина
bully -- запугивать
bun -- булочка
bunch -- связка, пучок
bundle -- сверток, пакет
burn -- ожог
bury -- хоронить, прятать
butterfly -- бабочка
bypass -- обходить, отклонить
camel -- верблюд
campaigner -- агитатор
camper -- турист
cancel -- отменить, сократить
candle -- свеча
cane -- трость, палка
canon -- правило, критерий
canvas -- холст, парус
capable -- способный
caprice -- каприз, причуда
capture -- захват, поймать
car -- автомобиль
car -- автомобиль, машина
care -- забота
carelessness -- беспечность
caress -- ласкать
carry -- нести, везти
case -- случай
cashier -- кассир
catch -- ловить
cathedral -- собор
cave -- пещера
celerity -- быстрота
certain -- уверенный
cession -- уступка
chain -- цепь
chair -- кресло, стул
chairman -- председатель
chalk -- мел
challenge -- вызывать, вызов
charity -- милосердие
charm -- очарование
chemist's -- аптека
civil -- гражданский
clerk -- чиновник
clip -- стричь, обрезать, зажимать
cloth -- ткань
cloud -- облако
coach -- тренировать, инструктор
coal -- уголь
coarse -- грубый
coast -- побережье
coastal -- береговой
cock -- петух, задирать
coil -- виток, катушка
collapse -- упадок сил
colourless -- бесцветный
comb -- гребенка, расчесывать, расчесать
come -- подходить, прибывать
common -- общий
community -- община
compatibility -- совместимость
comprise -- включать, заключать в себе, содержа
concern -- относительно, касательно (не about)
concrete -- бетон
confirm -- подтверждать, одобрять
conformation -- соответствие
confusion -- путаница
congratulation -- поздравление
consider -- рассматривать, полагать, считать
contain -- иметь в своём составе (не consist)
content -- содержание, содержимое (не оглавлен
conversation -- беседа
core -- центр, основная часть
corner -- угол, край
corner -- угол
crash -- авария
crazy -- безумный
crimson -- багровый
crooked -- кривой
crossroad -- перекресток
crown -- корона
curlers -- бигуди
damn -- проклятие
dark -- темнота
dedicate -- посвящать, посвятить
deed -- подвиг, дело
deep -- глубокий
defective -- имеющий недостатки
degree -- ученая степень
deliberately -- сознательно, обдуманно
delicate -- изящный
delightful -- восхитительный
depend -- зависеть
depth -- глубина
describe -- описывать
description -- описание
design -- замысел
developer -- развивающийся (о человеке)
devolve -- передавать
diamond -- алмаз
discretion -- свобода действий
dishonourable -- бесчестный
distribute -- распространять
drag -- тащить
draw -- тащить, тянуть, чертить, рисовать
dressmaker -- портниха
dribble -- вести мяч
drought -- засуха
drum -- барабан
drum -- барабан
drum -- барабан
drunkard -- пьяница
due -- должное, то, что причитается
dump -- разгружать
duster -- тряпка, щетка
eagerly -- охотно
eagle -- орел
earn -- зарабатывать
earthquake -- землетрясение
ease -- покой, непринужденность
effort -- усилие, напряжение
eggplant -- баклажан
either -- любой из двух, оба, и тот и другой
eject -- выгонять, выбрасывать
elaborate -- тщательно, детально разработанный
elbow -- локоть
elder -- старший
elderly -- пожилой
election -- избрание, выборы
eligible -- подходящий
eligible -- имеющий право, годный, подходящий
endless -- бесконечный
endorse -- подтверждать, одобрять (не confirm)
enough -- достаточный
enough -- достаточно
enrage -- бесить 
entrant -- абитуриент
estate -- имение
ever -- когда-либо
examine -- рассматривать, исследовать, изучать
eye -- глаз
fable -- басня
fable -- басня
failure -- провал
favorite -- любимый
fearless -- бесстрашный
feature -- особенность, функция
feedback -- обратная связь
feet -- ноги
fetch -- приносить (не bring)
feverish -- возбужденный (не exciting)
few -- несколько
fighter -- боец, борец
finger -- палец
fir -- пихта, ель
fireworks -- фейерверк
flavour -- вкус, аромат
flesh -- тело, плоть, мясо
flit -- перелетать
flock -- стадо, стая
flood -- наводнение
floor -- пол, этаж
flour -- мука
flu -- грипп
flush -- краснеть, покраснеть
flute -- флейта
flutter -- махать
fog -- туман
foggy -- туманный
follow -- следовать
follow -- следовать (за)
follower -- последователь
following -- следующий
folly -- неосмотрительность, недальновидност
forefather -- предок
forehead -- лоб
former -- бывший
fragrance -- аромат
furious -- бешеный ("f" первая)
further -- дальнейший, добавочный
futile -- безрезультатный
gang -- банда
gap -- пропуск, пробел
gasoline -- бензин
gather -- собираться
gem -- драгоценный камень
general -- общий, повсеместный (не common)
generally -- вообще, обычно
generous -- великодушный
gift -- подарок
glance -- быстрый взгляд
gonna -- собираться что-либо сделать
goodness -- доброта; великодушие; любезность
grab -- хватать(ся)
grateful -- благодарный
gratitude -- благодарность
greedy -- алчный
greenness -- зелень
greybeard -- старик
grim -- жестокий, свирепый, мрачный
grin -- ухмыляться, усмешка
grocery store -- бакалейный магазин
ground -- земля
growth -- рост
grumble -- ворчать
guard -- хранить
guess -- отгадывать, догадка
guessing -- гадание
guide -- руководство (текст, не начальство)
guilt -- вина, виновность (не fault)
guilty -- виноватый (не faulty)
gun -- огнестрельное оружие
guy -- парень
habit -- привычка
hair -- волосы
hammer -- молоток
handkerchief -- носовой платок
hang -- вешать
hangar -- ангар
happen -- случаться, происходить
happen -- случаться
harbour -- гавань
hardworking -- трудолюбивый
harp -- арфа
harsh -- грубый, резкий (не rough)
harshly -- грубо, резко (не roughly)
harvest -- урожай
haste -- спешка (не hurry)
hay -- сено
heap -- куча (не pile)
heartily -- сердечно
heel -- пятка, каблук
heir -- наследник
hell -- ад
hen -- курица
highlight -- выделять
hike -- путешествовать пешком
hinder -- препятствовать, мешать
hint -- намек, намекать
hiss -- свистеть, шипеть, свист
hit -- удар
hole -- дыра
hollow -- пустой
homeless -- бездомный, бомж
hostel -- общежитие
hostile -- враждебный
hug -- крепко обнимать
humble -- скромный
hunger -- голод
hypocrisy -- лицемерие
idle -- бесполезный
ignition -- зажигание, воспламенение
illumination -- освещение
immense -- огромный
immortal -- бессмертный
impassive -- бесстрастный
impotent -- бессильный
impression -- впечатление
improvement -- улучшение
indicate -- означать
indictment -- акт (обвинительный)
indisputable -- бесспорный
induction -- вступление, введение
inflict -- наносить удар
infuriate -- беспредельный
inhabitant -- житель
inheritor -- наследник
inhuman -- бесчеловечный
ink -- чернила
inkpot -- чернильница
inn -- гостиница, постоялый двор
innocence -- невинность, невиновность
innocent -- наивный, невинный
innumerable -- бесчисленный
inscription -- надпись
insist -- настаивать
insomnia -- бессонница
intercourse -- общение
intimidate -- пугать, запугивать
introduction -- введение
invade -- вторгаться
invader -- захватчик
invaluable -- бесценный
invention -- изобретение
inventor -- изобретатель
invincible -- непобедимый
invite -- приглашать
irregular -- неправильный
irreproachable -- безукоризненный, безупречный
irrevocable -- бесповоротный
issue -- спорный вопрос
jar -- ссора
jealousy -- ревность
jersey -- джемпер (не jumper)
jewel -- драгоценность
joke -- анекдот
judgement -- приговор, суждение
jug -- кувшин
kayak -- байдарка
kettle -- чайник
kick -- пинать, пнуть
kingdom -- королевство
knight -- рыцарь
knock -- стучать, стук
labour -- труд, трудиться
lack -- недостаток
ladder -- лестница
lame -- хромой
lampshade -- абажур
late -- поздний
latter -- последний
laugh -- смех
lawn -- лужайка
lawyer -- адвокат
lead -- вести
lean -- прислонять(ся)
lease -- арендовать (помещение)
leg -- нога
let -- позволять
liable -- склонный, подверженный
lie -- лежать
likewise -- так же
link -- ссылка
loaf -- батон
loaf -- батон
log -- бревно
lollipop -- леденец
loose -- свободный
lorry -- грузовик (не truck)
lot -- жребий, судьба
luggage -- багаж
madness -- безумие ("m" первая)
marriage -- брак
matter -- дело, вопрос, иметь значение
mean -- значить, подразумевать
means -- средства
meet -- встречаться, знакомиться
melt -- таять
merchant -- торговец
merciless -- беспощадный
mercy -- милость
mice -- мыши
midwife -- акушерка
mighty -- могущественный
mill -- фабрика, завод, мельница
mind -- разум, мнение
miner -- шахтер
miserable -- несчастный
misery -- страдания, нищета
miss -- промах
mist -- дымка
misuse -- неправильное использование
moan -- оплакивать, стонать
moderate -- умеренный
monitor -- наставник, староста
monk -- монах
moral -- нравственный
motion -- движение
moustache -- усы
mouth -- рот
multistoreyed -- многоэтажный
mute -- немой
mutton -- баранина
mutton -- баранина
mysterious -- таинственный
mystery -- тайна
naive -- наивный
native -- родной
naughty -- непослушный
naval -- военно-морской
neatly -- аккуратно
neatness -- аккуратность
needle -- игла
negro -- негр
neighbour -- сосед
nephew -- племянник
niece -- племянница
nitrogen -- азот
noble -- человек благородного происхождения
nod -- кивок
noiseless -- бесшумный
nonsense -- бессмыслица
obligation -- гарантия
obtain -- получать, добиваться
occasionally -- время от времени
occur -- происходить, случаться, совершаться
omit -- пропускать, не включать
once -- однажды
opinion -- взгляд, мнение, убеждение
order -- приказ
otherwise -- по-другому
ox -- бык
painful -- причиняющий боль, мучительный
palace -- дворец
pale -- бледный
pan -- сковорода
pancake -- блин
parachute -- парашют
pass -- пропуск (документ)
passion -- азарт
penalty -- наказание, штраф
pertain -- имеющий отношение
petrol -- бензин
pick -- собирать, выбирать
pile -- куча
pineapple -- ананас
possession -- владение
postgraduate -- аспирант
postman -- почтальон
pot -- котелок
pour -- лить
poverty -- бедность
powerful -- крепкий
powerless -- бессильный
practise -- заниматься
precious -- драгоценный
pregnant -- беременная
prejudice -- предрассудок
previous -- предыдущий
priceless -- бесценный
pride -- гордость
proceed -- продолжать
profit -- прибыль
prominent -- выдающийся
prompt -- проворный, быстрый
pronunciation -- произношение
proper -- правильный
properly -- правильно, должным образом
properly -- должным образом, как следует
property -- собственность
prosperity -- процветание, благосостояние
proud -- гордый
proverb -- пословица
provision -- заготовка
pub -- трактир, гостиница
pull -- тянуть, тащить
push -- толчок
questionnaire -- анкета
quinsy -- ангина
raid -- нападение
railway -- железная дорога
rainbow -- радуга
raincoat -- плащ
raise -- поднимать, возвышать
ram -- баран
ram -- баран
raven -- ворон
raw -- сырой
reach -- достигать
receive -- получать
recent -- недавний, свежий
recently -- недавно
reckless -- безрассудный
rectify -- исправлять (не correct)
redistribution -- перераспределение
regret -- жалеть
reign -- царить, господствовать
relate -- устанавливать связь
relief -- облегчение, утешение
relocation -- переселение
remain -- оставаться
remark -- замечать, замечание
remedy -- лекарство
remember -- помнить
report -- отчет, доклад
reproduce -- воспроизводить
require -- нуждаться, приказывать, требовать
requirement -- требование
resistance -- сопротивление
respectable -- почтенный, порядочный
respectable -- представительный
responsibility -- ответственность
rest -- отдых
restless -- беспокойный
restrict -- ограничивать
retell -- пересказать
retire -- уходить, удаляться, оставлять должн
revise -- проверять, исправлять
ring -- звонить (не call)
rose -- роза
rotate -- вращать, чередовать
roulette -- рулетка
row -- грести
rub -- тереть, стирать, трение
ruby -- рубиновый
rucksack -- рюкзак
rueful -- унылый
ruler -- линейка, правитель
rumour -- слух, молва
runner -- бегун
runtime -- рабочий цикл
rush -- устремляться, бросаться, мчаться
sack -- мешок
sacred -- священный
sacrifice -- жертва
sadness -- печаль
salary -- оклад
salesman -- продавец
same -- тот же самый
sand -- песок
sandy -- песчаный
scarlet -- алый
scratch -- царапина
scream -- крик, вопль
scythe -- коса, косить
section -- раздел (в книге)
seem -- казаться
seep -- просачиваться, капать
selfless -- самоотверженный
separately -- отдельно
servant -- слуга
settle -- поселить(ся)
settlement -- поселение
severe -- суровый, жестокий (не brutal)
shake -- трясти, дрожать
shark -- акула
shark -- акула
shed -- сарай
sheep -- овца, овцы
shell -- раковина, скорлупа
shit -- говно, дерьмо
shore -- берег моря, озера
shoulder -- плечо
shy -- застенчивый, робкий
sickle -- серп
similar -- аналогичный
since -- с тех пор как
sincere -- искренний
sink -- тонуть
skater -- конькобежец
skip -- пропуск, игнор
skyscraper -- небоскреб
slave -- раб
sledge -- ехать на санях
sleeve -- рукав
sleigh -- сани, салазки
slippery -- скользкий
slogan -- лозунг
slope -- склон, наклон, гора для катания
smell -- запах
smile -- улыбаться, улыбка
smite -- поражать (удярять, бить)
society -- общество
sole -- единственный (не only)
solid -- твердый
somehow -- так или иначе
spoil -- баловать
squirrel -- белка
stare -- уставиться (на)
steady -- устойчивый, твердый
sterile -- бесплодный
still -- все еще (она все еще красива)
still -- тихий, все еще
stone -- камень
stork -- аист
strike -- бастовать
strike -- бастовать
substance -- вещество
subway -- метро
such -- такой
suddenly -- неожиданно
sufficient -- достаточный
suggest -- предлагать, советовать, внушать
sunbeam -- солнечный луч
sunburnt -- загорелый
supply -- снабжение, поставка
suppose -- предполагать
sure -- уверенный, убедившись
surface -- поверхность
tactless -- бестактный
team -- команда, группа
tear -- разрыв, рвать(ся)
though -- однако, хотя
thrifty -- бережливый
throw -- кидать, бросать
tools -- инструменты
touch -- трогать, касаться
toward -- к
tower -- башня
tower -- башня
track -- дорожка
transfer -- перемещение
trouble -- беспокойство
turn -- поворот
tutor -- наставник
unconscious -- бессознательный
underwear -- нижнее белье
undoubtedly -- безусловно
unscrupulous -- бессовестный
unselfish -- бескорыстный
useless -- бесполезный
utterly -- абсолютно
velvet -- бархат
velvet -- бархат
vigilance -- бдительность
wall -- стена
watermelon -- арбуз
wear -- носить (одежду)
weariness -- усталость
wedding -- свадьба, венчание
weep -- плакать
welfare -- благосостояние
wheat -- пшеница
wheelbarrow -- тачка
whenever -- всякий раз когда
whether -- ли
whirl -- вихрь
wing -- крыло
wipe -- вытирать
wisdom -- мудрость
wisely -- мудро
wizard -- колдун, специалист своего дела
wonder -- удивление
wood -- лес, древесина, дрова
wool -- шерсть
worry -- беспокоить
worst -- наихудший
wrath -- гнев, ярость (не anger)
wreck -- крушение (не crash и не smash)
yeah -- да
absent -- отсутствующий (не missed)
accept -- соглашать(ся)
accepted -- принятый
accident -- случай, авария
account -- счет, расчет
ache -- боль (не pain)
achievement -- выполнение, достижение
adjust -- регулировать, приспосабливать
admirable -- замечательный (не wonderful)
admire -- восхищаться
admission -- допуск, вход, прием
admit -- допускать, соглашаться (не agree)
ads -- реклама
adult -- взрослый
advance -- продвижение вперед, успех
adventure -- приключение
advice -- cовет
afford -- позволить себе
aids -- вспомогательные средства
aim -- цель
air -- воздух
aircraft -- самолет
airsick -- страдающий от воздушной болезни
alarm -- тревога
alien -- чужестранец
aloof -- поодаль, вдали, в стороне (l в сере
amaze -- изумлять, поражать
amount -- количество, сумма, составлять (сумм
amuse -- смешить
anger -- гнев
announce -- объявлять
anywhere -- где-нибудь
apart -- в стороне, отдельно (не aside)
apiece -- за штуку, поштучно
apology -- извинение
apparently -- очевидно
appear -- появляться
appointment -- условленная встреча
approve -- одобрять
argue -- спорить
arrange -- приводить в порядок, расставлять
arrest -- арест
art -- искусство
artful -- хитрый, ловкий
ashore -- на берег
aside -- в стороне (не apart)
asleep -- спящий
assume -- допускать
attend -- посещать, обслуживать
attorney -- юрист
audience -- публика
audience -- публика, зрители
avoid -- избегать
awake -- будить
aware -- знающий
away -- прочь
bacon -- бекон
bag -- сумка
balance -- весы
band -- лента, оркестр, ансамбль (музыкальн
band -- тесьма
bang -- удар
barber -- парикмахер
bare -- голый, обнаженный
barrel -- бочка
bastard -- внебрачный ребенок, ублюдок
bat -- летучая мышь
bath -- ванна
battle -- битва
bay -- залив, бухта
beans -- фасоль
beast -- зверь
beauty -- красота
become -- становиться
bedsheet -- простыня
beef -- говядина
beet -- свекла
beg -- просить, умолять
behave -- вести себя
behaviour -- поведение
behind -- позади
bell -- колокол
belong -- принадлежать
belt -- пояс, ремень
berry -- ягода
beside -- рядом, около (не nearly)
besides -- кроме
beware -- осторожно
bit -- кусочек, немного
bitch -- сука
blanket -- одеяло
blast -- взрыв
bleed -- кровоточить
blind -- слепой, ослепленный
blink -- мигать, мерцать
blond -- блондин
bloody -- кровавый
boat -- лодка, пароход
boiled -- вареный, кипяченый
bond -- связь, узы, оковы
booth -- кабинка
booth -- киоск
bore -- скука (r есть)
borrow -- брать в долг
both -- оба
bow -- поклон
bowl -- миска
brace -- связывать, скреплять
brake -- тормоз
branch -- ветка
brass -- установить
brawl -- уличный скандал
breakfast -- завтрак
breast -- грудь, молочная железа
breath -- дыхание
breathe -- дышать
breathe -- дышать
breed -- порода
brew -- затевать, надвигаться
brief -- краткий
bring -- приносить, приводить
broadcast -- передача по радио
brooch -- брошь
brush -- кисть
bug -- жук
bunch -- связка, пучок
burst -- заливаться, разражаться (гневом, сл
bury -- хоронить
busy -- занятой
buzz -- жужжание
cab -- такси
cabbage -- капуста
cable -- кабель
cage -- клетка
calm -- успокаивать
camp -- лагерь
cap -- шапка
cap -- кепка
care -- заботиться, переживать
carriage -- вагон
carton -- коробка
cartoon -- комикс
case -- чехол, футляр
cash -- наличные деньги
cast -- бросать, кидать (не toss)
castle -- замок
caution -- осторожность
cave -- пещера
caviar -- икра
celebrate -- праздновать
century -- век
certainly -- конечно
chain -- цепь
chamber -- кабинет
chambermaid -- горничная
charge -- плата, стоимость, взимать плату
chase -- погоня
chasing -- уклоняющийся (-ing)
chat -- беседа, болтовня
chatterbox -- болтунья
cheap -- дешевый
cheer -- настроение
cheer -- утешать
cherry -- вишня
chick -- цыпленок
chief -- шеф, начальник
chin -- подбородок
china -- фарфор
choir -- хор
circumstance -- обстоятельство, условие
citizen -- гражданин
claim -- требовать
claim -- требование
claw -- коготь
clearly -- ясно, очевидно
cliff -- отвесная скала
closet -- чулан
clutch -- когти, лапы, хватка
coach -- автобус, купе
coin -- монета
coincidence -- совпадение
collapse -- крах
collar -- воротник
college -- колледж
come -- приходить, приезжать
compartment -- купе
competition -- соревнование
complaint -- жалоба
complicated -- сложный
comprehensive -- богатый
compulsory -- обязательный
condition -- условие
condole -- соболезновать
confuse -- смущать
congratulate -- поздравлять
consolation -- утешение
consult -- советоваться
contact -- устанавливать связь
contain -- вмещать
contributor -- сотрудник
conveniences -- удобства
convince -- убеждать
cook -- повар
cooperation -- сотрудничество
cord -- шнур
corn -- кукуруза
corner -- угол
cost -- стоить, стоил
cost -- цена, стоимость
cosy -- уютный
cotton -- хлопок, хлопчатобумажный
couch -- диван (не divan)
cough -- кашель
cough -- кашель
court -- суд
cousin -- двоюродный брат
coverage -- охват, репортаж
credit -- доверие
creep -- ползать
crew -- судовая команда, экипаж
crime -- преступление
cross -- пересекать
crouch -- присесть
crystal -- хрусталь
curse -- проклятие
curtain -- занавеска
curve -- кривая
customer -- клиент
damage -- вред
danger -- опасность
dangerous -- опасный
dawn -- рассвет
decision -- решение
demand -- требовать, нуждаться
department -- отдел
design -- замысел
destroy -- разрушать
dial -- циферблат
difference -- разница
difficult -- трудный
direct -- прямой
dirt -- грязь
dirty -- грязный
discover -- узнавать, обнаруживать
display -- показ
dissolve -- растворять(ся)
distant -- отдаленный
dive -- ныряние в воду
dodge -- обман, уловка
doubt -- сомнение, сомневаться
downpayment -- задаток
drawer -- ящик (стола)
dream -- мечтать, видеть сны
dress -- платье, одеваться
dressing -- приправа
drugstore -- аптека (не chemist's)
drunk -- пьяный
duck -- утка
due -- должный, обязанный
dull -- скучный (не bore)
dump -- свалка
during -- во время
duty -- пошлина
dyed -- крашенный
eager -- нетерпеливый
earache -- боль в ухе
earrings -- серьги
earth -- земля
ease -- покой (не rest)
echo -- эхо
effort -- попытка
embarrass -- смущать(ся)
emerge -- появляться
emergency -- крайняя необходимость
employer -- работодатель
enemy -- враг
engaged -- занятый, помолвленный
enormous -- громадный
enough -- достаточный
entertainment -- развлечение
enthusiastic -- восторженный
envelope -- конверт
envelope -- обертывать, окутывать
equipment -- снаряжение, оборудование
equipment -- оборудование
especially -- особенно
even -- даже
event -- событие
ever -- когда-либо
everywhere -- везде
evidence -- свидетельство, доказательство, улик
evil -- зло, вред
examine -- рассматривать, исследовать (не test
exchange -- обмен
excite -- возбуждать
exciting -- волнующий, великолепный
exhibition -- выставка
exist -- существовать
expense -- расход
expensive -- дорогой
experience -- опыт
experience -- опыт
explain -- объяснять
explode -- взрывать(ся)
explosion -- взрыв
extend -- простираться
external -- наружный
fail -- неудача, провал
faint -- слабый
fair -- любезно, хорошо, справедливый
fairly -- довольно (не rather)
fairy -- волшебный
faith -- вера
familiar -- знакомый
famous -- известный
fancy -- воображать, представлять себе
fare -- плата за проезд
farther -- дальше
fat -- жир, сало
fault -- вина, недостаток, ошибка
favour -- одолжение, услуга, польза
favour -- благосклонность, одобрение
feather -- предмет гордости, достижение
feature -- особенность
feel -- чувствовать
fell -- упал (от fall)
fellow -- приятель
female -- женский, женщина
fence -- забор
fever -- жар, лихорадка
few -- мало
fiction -- беллетристика, вымысел
fiddlesticks -- вздор
fight -- бороться, бой
fine -- штрафовать
fist -- кулак
fit -- подходить, соответствовать, устраив
fitting -- примерка
fix -- починить, наладить, назначить
flabbergasted -- поражен, изумлен
flashlight -- карманный фонарь
flesh -- тело, плоть
flicker -- мерцание
flip -- щелчок, легкий удар
float -- плавать (на поверхности)
flow -- течение
flower -- цветок
fold -- сгиб, изгиб, складка
folk -- народная
follow -- следовать
fond -- пристрастный, любящий
fool -- дурак
footwear -- обувь
forecast -- прогноз
forehead -- лоб
forest -- лес
forever -- вечно
forget -- забыть
forgive -- прощать
fork -- вилка
forth -- вперед, дальше (в пространственном 
fortnight -- две недели
fortune -- удача, счастье
foyer -- фойе
frankly -- откровенно
freight -- груз, грузовой
fresh -- свежий
fried -- жареный (не roast)
frighten -- пугать
fulfil -- выполнить
fun -- шутка, веселье
fun -- шутка, веселье, забава
fur -- мех, шкура
furniture -- мебель
furs -- меха (от fur)
garden -- сад
gargle -- полоскание
gasp -- затрудненное дыхание
gatecrashers -- незваные гости
generosity -- великодушие
giant -- гигант
glad -- радостный, довольный
glare -- ослепительный яркий свет
glitter -- блеск, блестеть
glove -- перчатка
glove -- перчатка
golden -- золотой
gossip -- сплетня
government -- правительство
gracious -- милосердный
grass -- трава
grave -- могила
greet -- приветствовать
greet -- приветствовать, здороваться (именно
grey -- серый
grief -- горе
guest -- гость
guide -- гид, экскурсовод
hairdresser -- парикмахер
hairspray -- лак для волос
ham -- ветчина
handle -- обращаться с, управлять
hardly -- едва
heat -- жара
heaven -- небо
heel -- пятка
helicopter -- вертолет
hesitate -- колебаться, сомневаться, не решатьс
highway -- шоссе
hire -- прокат, наем
hiss -- шипение, свист
honey -- мед
honour -- честь
hood -- капюшон
hook -- крюк, крючок (рыболовный)
horror -- ужас
household -- домашнее хозяйство
hug -- крепко обнимать
humid -- влажный
humidity -- влажность
humorous -- смешной
hunt -- охота
hurry -- спешить, торопиться, спешка
hurt -- рана, болеть, причинить боль, повре
ice -- лед
icebox -- холодильник (морозильник)
impossible -- невозможный
impressive -- впечатляющий
incredible -- невероятно (не impossible)
indeed -- неужели, действительно
indeed -- в самом деле (не really)
indicate -- показывать, указывать
indifference -- безразличие
indigestion -- несварение, расстройство
inevitability -- неизбежность
inferior -- худший, плохой
influence -- влияние, влиять
inquiry -- расспросы, наведение справок
instant -- миг, мгновение
instantly -- немедленно
intelligence -- ум
intention -- намерение
interior -- внутренняя часть
interrogative -- вопросительный
introduce -- предстaвлять, знакомить
involve -- вовлекать
iron -- железо
irritation -- раздражение
issue -- выпуск, издание, выпускать
jam -- варенье, джем
jam -- затор, давка
jerk -- резкое движение, толчок
joke -- шутка
jolly -- очень, веселый
journey -- путешествие
joy -- радость
jumper -- джемпер
jungle -- джунгли
junior -- младший
justice -- справедливость
keen -- страстный
keep -- (со)держать, сохранять
keepsake -- подарок, сувенир на память
kidney -- почка (анатом.)
kneel -- стоять на коленях
lake -- озеро
lamp -- лампа
laugh -- смех
leader -- лидер
leather -- выделанная кожа
lettuce -- салат
library -- библиотека
lifeboat -- спасательная лодка
linen -- белье
liquid -- жидкость
list -- список
litter -- мусор, сорить
liver -- печень
lobby -- приемная, фойе
lot -- много
lovely -- прекрасный, восхитительный
luck -- удача, везение
luck -- удача
lucky -- счастливый (не happy)
luggage -- багаж
lunch -- ленч
luxurious -- роскошный
mad -- обезумевший
mad -- сумасшедший
magazine -- журнал
maid -- горничная
male -- самец
map -- карта
market -- рынок
married -- женатый, замужняя
mascara -- тушь
mass -- масса
mess -- беспорядок, путаница
military -- военный
mill -- мельница
miss -- потеря, утрата
monster -- чудовище
moot -- спорный
murmur -- шепот
muscle -- мышца
mushroom -- гриб
mustard -- горчица
mutter -- бормотать
nail -- ноготь, гвоздь
nail -- гвоздь
naked -- голый, обнаженный (окончание -ed)
nasty -- скверный, плохой
nature -- природа
nearby -- близлежащий, соседний
necessary -- необходимый
necklace -- ожерелье
never -- никогда
noodle -- лапша, балда
nor -- не, также не
nuisance -- досада
nuke -- грохнуть, преднамеренно убить (не k
nursery -- детский, ясли
nut -- орех
oblige -- обязывать
observe -- наблюдать
obvious -- очевидный, явный
obviously -- очевидно
occupation -- занятие
occur -- случаться, происходить
odd -- странный
odd -- нечетный
offer -- предлагать
often -- часто
oil -- масло
opposite -- противоположный
ought -- следовало бы
ounce -- унция
outlet -- выход, выходное отверстие
overdrawn -- преувеличенный, превышенный
overdue -- запоздалый
overjoyed -- вне себя от радости, очень довольны
overtime -- сверхурочные
own -- иметь, владеть, свой, собственный
oyster -- устрица
pace -- шаг (не step)
pad -- подушка
palm -- ладонь
pants -- трусы
parcel -- пакет (не pocket, не bundle)
parlour -- кабинет (не chamber)
parrot -- попугай
particular -- редкий, особенный
pat -- похлопывание, шлепанье
patient -- терпеливый
pattern -- образец
pay -- платить, зарплата
payment -- плата
peace -- мир
peach -- персик
pear -- груша
pearl -- жемчуг, жемчужный
peas -- горошек, горох
pension -- пенсия
perfectly -- совершенно
perform -- делать, выполнять
performance -- спектакль
perfume -- духи
perhaps -- возможно, может быть
permanent -- постоянный
permission -- разрешение
permit -- разрешать
personal -- личный
pie -- пирог
piece -- кусок
pile -- куча
pill -- таблетка, пилюля
pillow -- подушка
pin -- булавка
pink -- розовый
pipe -- труба, трубопровод
pistol -- пистолет
pitch -- бросок, подача
plain -- плоский, ровный
plant -- завод
pleasure -- удовольствие
pool -- бассейн
porch -- крыльцо
possibly -- возможно (не probably), окончание "
powerful -- мощный
presence -- присутствие
pressure -- давление
pretend -- притворяться
priest -- священник
prison -- тюрьма
prisoner -- заключенный
prohibit -- запрещать
promise -- обещать
pronouns -- местоимения
proposal -- предложение
propose -- предлагать (не suggest)
protect -- защищать
prove -- доказывать, подтверждать
pull -- тянуть, тащить
pump -- насос
punch -- удар кулаком
purpose -- цель, намерение
puzzle -- головоломка
quarter -- четверть, квартал (четверть года)
quite -- вполне, совсем
rabbit -- кролик
racket -- ракетка
rage -- гнев, ярость
rail -- перила
range -- диапазон
rare -- редкий, недожаренный
rat -- крыса
react -- реагировать
receive -- получать
refuse -- отвергать
regard -- внимание, забота
relax -- расслаблять(ся)
release -- освобождать, выпускать
remind -- напоминать
replace -- заменять
reporter -- докладчик
reserve -- запас
respect -- уважение
respond -- реагировать
response -- ответ
responsibility -- ответственность
rich -- богатый, плодородный
ring -- кольцо, звон, звонок, звенеть, звон
risk -- риск
roar -- реветь, орать, хохотать
roast -- жареный (не fried)
robbery -- грабеж
rope -- веревка
rough -- грубый
rub -- трение, стирание
sake -- ради чего-либо
sand -- песок
scar -- шрам
scarf -- шарф
schedule -- расписание, таблица, планировать
scratch -- царапина
scream -- вскрикнуть, зареветь, визг, вопль
screw -- винт, болт
script -- сценарий
seal -- печать
seaside -- морское побережье (не coastal)
seek -- искать
separate -- отдельный
serve -- служить
shatter -- разбить вдребезги
shelf -- полка
shell -- оболочка
shindy -- шум, скандал
shine -- сиять, блестеть
shot -- попытка, выстрел
shotgun -- дробовик
shoulder -- плечо, толкать
shove -- толчок ("ov" в середине)
shower -- душ, ливень
shower -- ливень
shrimp -- креветка
sick -- больной (не pain,ache)
sidewalk -- тротуар
silent -- безмолвный
silver -- серебро
sip -- пить маленькими глотками
site -- место, участок
skull -- череп
slight -- стройный, тонкий
smash -- катастрофа (не crash)
smoke -- дым
smooth -- гладкий, ровный
snake -- змея
somehow -- как-нибудь, так или иначе
song -- песня
soul -- душа
split -- раскалывание
stack -- куча
startle -- испуг, страх
steady -- твердый, устойчивый
steam -- пар
stir -- шевеление
stomach -- желудок
strain -- натяжение, растяжение
stranger -- незнакомец
stream -- поток, течение
strength -- сила
stride -- большой шаг
strip -- полоса
stumble -- спотыкание
stun -- оглушать
subject -- тема
suck -- сосать
suggest -- предлагать
supply -- снабжать
support -- поддержка
surround -- окружать
survive -- выжить
suspect -- подозревать
swallow -- глоток
swear -- клятва
sweet -- сладкий
swell -- раздуваться
tag -- бирка, ярлык
tail -- конец, хвост
tail -- хвост
tale -- повесть, сказка, история
tall -- невероятный, высокий
tall story -- небылица (2 слова)
tap -- водопроводный (газовый) кран
target -- мишень
taste -- пробовать, иметь вкус
taste -- вкус
temple -- храм
terrible -- страшный
terrify -- вселять ужас
thumb -- большой палец (руки)
tip -- кончик (тонкий конец (пальца))
tongue -- язык
totally -- полностью, совершенно
tough -- жесткий
towel -- полотенце
trace -- след (не trail)
traffic -- движение транспорта
trail -- след (не trace)
trap -- капкан, ловушка
treat -- угощение
tremble -- дрожать
trick -- обман, хитрость
trunk -- ствол (дерева)
twice -- дважды
uncle -- дядя
universe -- вселенная
unless -- если не; пока не
upset -- опрокидывать, переворачивать
upstairs -- вверх (по лестнице)
usually -- обычно
van -- фургон
vanish -- исчезать
various -- различный
vehicle -- транспортное средство
victim -- жертва
village -- деревня
vinegar -- уксус
violin -- скрипка
visible -- видимый
vivid -- живой, яркий
volume -- объем, громкость
waiter -- официант
wake -- будить, просыпаться
wander -- бродить, скитаться
wash -- мыть(ся)
waste -- тратить , использованный, негодный
waste -- бесполезная трата
weight -- вес
weird -- таинственный
whip -- кнут
whistle -- свист
witness -- свидетель, очевидец
wonderful -- удивительный
wooden -- деревянный
worse -- хуже (от bad)
worth -- цена (не price)
wrist -- запястье
wrong -- неправильный, не тот
youth -- молодежь
able -- способный, умелый
abroad -- за границей
absence -- отсутствие
absolve -- прощать, оправдывать (не forgive)
abundance -- богатство, изобилие
accelerate -- ускорять(ся)
accent -- подчеркивать, произносить
accident -- несчастный случай
accidentally -- случайно, нечаянно
accommodate -- согласовывать, улаживать, примирять
accommodate -- согласовывать, улаживать, примирять
accompany -- сопровождать
accompany -- сопровождать
accord -- согласие, гармония
accord -- согласие, гармония
account -- счет, оценка, причина
accuracy -- точность, аккуратность
achieve -- достигать, успешно выполнять
acknowledge -- признавать, вознаграждать
acquaint -- знакомить
acquaintance -- знакомство, знакомый
across -- через
action -- действие
activity -- деятельность, активность
adamant -- алмаз, твердый, непреклонный (не di
adapt -- приспособить, переделать
adept -- знаток, сторонник
admiration -- восхищение
admit -- допускать
advanced -- передовой
advantage -- преимущество, выгода
aerophone -- радиотелефон
affability -- любезность, вежливость
affair -- дело, занятие
affectionate -- любящий, нежный
after all -- в конце концов (2 слова)
afterwards -- впоследствии, позже
agent -- деятель, исполнитель
aggrieve -- обижать, огорчать
agitation -- дискуссия, обсуждение (не агитация)
agriculture -- сельское хозяйство
ahead -- вперед (не forth)
aid -- помощь
alive -- живой
allow -- позволять
among -- среди
angle -- угол
angry -- сердитый
anyway -- в любом случае
approach -- приближение
arrive -- прибывать
ass -- осел
aunt -- тетя
avoid -- избегать, избежать
awake -- бодрствующий
award -- присуждать что-либо
aware -- сознающий
awful -- ужасный
backward -- назад, обратно, наоборот
badge -- знак, символ, эмблема
balance -- равновесие
ball -- шар, мяч
banner -- знамя
bare -- обнаженный
barely -- только, едва, лишь
bargain -- сделка
beach -- пляж; взморье
beam -- сияние
bear -- мишка
belt -- пояс, ремень
bend -- гнуться, сгибаться
beneath -- ниже, внизу
beside -- рядом с, около
beyond -- вдали
bit -- немного, кусочек
bite -- кусать(ся), жалить
blade -- лезвие
blow -- дуть
boat -- лодка, судно
bone -- кость, останки
bother -- беспокойство
brain -- мозг, ум
bright -- яркий, светлый
buddy -- приятель
bullet -- пуля
burn -- жечь, гореть
burst -- взрываться, лопаться
button -- пуговица, кнопка
calm -- тихий, успокаивать
cause -- причина
ceiling -- потолок
cell -- камера, карцер, ячейка
certainly -- конечно
chance -- возможность, шанс
cheek -- щека, наглость
chest -- грудная клетка
chief -- глава, главный
circle -- круг, окружность
click -- щелкать
climb -- подниматься (на) (среди них есть "b
clothes -- одежда
cloud -- облако, туча
coach -- тренер
coat -- пальто
colonel -- полковник
completely -- совершенно, полностью
concern -- отношение, иметь отношение (к) (не pertain)
conversation -- разговор, беседа
cool -- прохладный
cop -- полицейский
counter -- противоположный, противостоять
couple -- пара, два
crack -- треск
crawl -- ползание (не creep)
creature -- создание, тварь
crew -- экипаж (судна и т.п.)
crowd -- толпа
cruel -- жестокий, беспощадный
cruelty -- жестокость
crumb -- крошка
cry -- крик, кричать
cultivate -- обрабатывать
cupboard -- буфет
curds -- творог
cure -- лекарство, лечить (не drug)
curiosity -- любопытство, редкая вещь
curious -- любознательный
currency -- валюта
curse -- проклятие
curtain -- занавеска, занавес
curve -- изгиб, гнуть
cushion -- подушка
custom -- обычай
customer -- клиент
customs -- таможня
cute -- изящный, прелестный
cutlet -- котлета
daily -- ежедневно
dainty -- лакомство, деликатес
dam -- дамба, плотина
dame -- дама, пожилая женщина (не lady)
damp -- сырой, влажный
dance -- танец
dancer -- танцор
dandy -- нарядный, великолепный
dare -- сметь, отважиться
darkness -- темнота
darkness -- темнота, мрак
darling -- любимый, дорогой
dash -- оттолкнуть, отбросить
dawn -- рассвет, светать
deaf -- глухой
deafen -- оглушить, заглушить
deal -- значительное количество
dean -- декан
dear -- дорогой
deathless -- бессмертный
debt -- долг
decent -- приличный, скромный
deception -- обман, хитрость
decide -- решать
deck -- палуба
deck -- палуба
decorate -- украшать
delight -- восхищение, восхищаться
delivery -- доставка
demand -- требовать
dentist -- зубной врач
departure -- отъезд, отправление
desert -- пустыня, покидать
desire -- (страстное) желание
destination -- место назначения
devil -- дьявол, сатана
dig -- копать
dinner -- обед
direct -- прямой, руководить
directory -- справочник
disadvantage -- неудобство
disagreement -- несогласие
disappoint -- разочаровывать
disapproval -- неодобрение
disbelief -- недоверие
discord -- разногласие, раздоры
discuss -- обсуждать
discussion -- беседа
disgraceful -- позорный
dish -- блюдо
district -- район
dive -- нырять
divorce -- развод
doll -- кукла
doorway -- дверной проем
doubt -- сомнение
drag -- тащить(ся)
drug -- лекарство (не cure)
dry -- сухой
dust -- пыль
ear -- ухо
earth -- земля
edge -- острие, лезвие
edgeway -- острие
editor -- редактор
either -- любой (из двух)
either -- или
embassy -- посольство
emergency -- крайняя необходимость
engage -- нанимать, занимать, вовлекать
engine -- двигатель, мотор
entire -- целый, полный, весь
entrance -- вход
escape -- побег
exactly -- точно
exactly -- точно, именно
exercise -- упражнение
exhausted -- изнуренный
exile -- ссылать, изгнание
expectancy -- ожидание, надежда
explain --  объяснять
explorer -- исследователь
extension -- расширение
extra -- сверх (не above)
extremely -- крайне
eyepencil -- карандаш для век
fable -- басня, сюжет
fabric -- ткань, материя, сооружение
fade -- вянуть, блекнуть
fade -- увядать
faint -- слабый
faint -- слабый
fairy tale -- сказка (2 слова, 5 букв и 4 буквы)
faith -- вера
faithful -- верный
faithless -- ненадежный
fit -- годный
flame -- пламя, сияние
flat -- квартира
flight -- полет, рейс
foot -- ступня, нога
force -- сила, насилие (не power)
frame -- каркас
frown -- хмуриться
fuck -- к черту (не shit)
fucking -- чертов, долбаный, трах-й (не от shit)
gate -- ворота
gather -- собирать(ся)
gaze -- пристальный взгляд
gently -- мягко, нежно (не softly)
gesture -- жест
ghost -- призрак, привидение
glow -- свет, сверкать
gotta -- должен, должна (разговорное)
grace -- грация, изящество
grand -- грандиозный, большой, важный (не la
grandchildren -- внуки
grapes -- виноград
grasp -- понять, схватить
grin -- усмешка, ухмыляться
grip -- сжатие, хватка
hall -- зал, передняя, холл
hallway -- прихожая
handle -- ручка, рукоятка, удобный случай, во
hanger -- крюк, вешалка
harm -- беда, неприятность
hat -- шляпа
hat -- шляпа
hate -- ненавидеть
headache -- головная боль
headphones -- наушники
heart -- сердце
heater -- нагреватель
heaven -- небо, небеса, бог, провидение
heavy -- тяжелый
heavy -- тяжелый
hell -- черт
herring -- сельдь 
hiking -- пеший поход
hill -- холм
hit -- успех, удача, попадать в цель
hockey -- хоккей
hold -- держать(ся), выдерживать, захват, в
hole -- дыра
hope -- надеяться
horse -- конь
hose -- чулки
hospitality -- гостеприимство
host -- хозяин
hurry -- спешка, спешить
hurt -- ушибить, болеть, причинять боль
husband -- муж
ignorance -- незнание, невежество
ill -- больной
imagine -- воображать
immediately -- немедленно
in vain -- напрасно (2 слова)
income -- доход, заработок
incomprehension -- непонимание
instead -- вместо
island -- остров
jacket -- куртка, пиджак
join -- соединять(ся)
judge -- судья
knee -- колено
knee -- колено
knife -- нож
knitted -- вязанный, трикотажный
knock -- стук, удар
lamb -- ягненок, баранина
land -- земля, суша, приземляться, высажива
lark -- шутка, забава (не joke)
laundry -- прачечная, стирка
lawyer -- адвокат
lay -- класть, положить (не put)
leap -- прыгать, скакать
leap -- високосный, прыжок, прыгать
least -- наименьший
leather -- кожа, кожаный
leave -- оставлять, покидать, уезжать
leisure -- досуг
lend -- дать в долг
lip -- губа
load -- груз, грузить
loose -- свободный
loud -- громко
manage -- руководить
mark -- знак, оценка
marry -- жениться, выходить замуж
massage -- массаж
masterpiece -- шедевр
match -- спичка
matinees -- утренние спектакли
matter -- дело, сущность, материал
meal -- еда, есть, принимать пищу
means -- средство, способ
melon -- дыня
mend -- чинить, ремонтировать
mention -- упоминание
mention -- благодарность, упоминать
merry -- веселый, радостный (не jolly, funny)
metal -- металл, металлический
meter -- счетчик
middle -- средний
mild -- мягкий (не soft)
miracle -- чудо
mistrust -- недоверие, подозрение
motion -- движение
mountain -- гора
movie -- кино, фильм
narrow -- узкий
nearly -- почти, около (не almost)
neither -- ни тот, ни другой
nicest -- самый вкусный
noisy -- шумный
nonsense -- чепуха, ерунда (не bullshit)
noon -- полдень
nose -- нос, обоняние
note -- заметка
notice -- извещение, сообщение, уведомление
nowadays -- в наше время
numerous -- многочисленный
nurse -- няня, сиделка
nurse -- няня
oar -- весло
offer -- предложение, предлагать
ointment -- мазь
omelette -- омлет
onion -- лук
opinion -- мнение
option -- выбор (последняя буква n)
ordinal -- порядковый
pain -- боль
pair -- пара
pale -- бледный
party -- вечеринка, группа
pass -- передавать, проходить, пропуск, пер
pate -- паштет
path -- тропинка, путь
perfect -- совершенный
piece -- кусок
pin -- булавка, значок, прикалывать
pineapple -- ананас
pity -- жалость
place -- место
plain -- ясный, очевидный, равнина
plane -- плоскость, самолет
plate -- тарелка
plate -- тарелка
pleasant -- приятный
pleasure -- удовольствие
plum -- слива
pocket -- карман, мешок
poem -- стихотворение, поэма
polish -- лак
polite -- любезный, вежливый
pollution -- загрязнение
pool -- пруд, бассейн
poor -- бедный, несчастный
poor -- бедный
pork -- свинина
porridge -- каша
porter -- носильщик
postcard -- почтовая открытка
potato -- картофель
pour -- лить(ся), наливать
powder -- пудра
praise -- хвалить
prefer -- предпочитать
prepare -- готовить(ся)
prescription -- рецепт
pretty -- хорошенький
private -- рядовой
probability -- вероятность
probably -- вероятно
promise -- обещание
pyjamas -- пижама
quarrel -- ссора, ссориться
questionable -- сомнительный
quiet -- спокойный (не still)
quite -- вполне, совсем
quivering -- дрожащий
rate -- тариф, расценка, степень
rather -- скорее, лучше
ray -- луч
razor -- бритва
ready -- готовый
rear -- задняя сторона, тыл
rear -- задняя часть
recall -- припомнить, отозвать
receipt -- квитанция
reception -- прием
recover -- выздоравливать
recovery -- выздоровление
reduce -- уменьшать, понижать, сокращать
reference -- рекомендация, ссылка, справка
refreshments -- закуски и напитки
refrigerator -- холодильник
refuse -- отказывать
regards -- привет, поклон
relation -- отношение, связь
relationship -- родственные связи
rely -- полагаться, доверять
remain -- оставаться
remember -- помнить
remote -- дистанционный, удаленный
rent -- брать напрокат, снимать жилье, квар
repair -- ремонтировать, ремонт, починка
request -- просьба
research -- исследование
resident -- постоянный житель
respect -- уважение, уважать
restriction -- ограничение
reveal -- открывать, разоблачать, обнаруживат
ride -- ехать (верхом)
rifle -- винтовка
rip -- разрез, разрыв
roar -- рев, грохот
rock -- камень, скала
roof -- крыша
rot -- вздор, нелепость
route -- маршрут, путь, направлять
rowing -- гребля, выговор
rude -- грубый, резкий, невоспитанный
rush -- спешка, бросаться
sad -- печальный
safe -- безопасный
sail -- парус, плыть
sailor -- матрос
sake -- ради, для
salmon -- лосось
sandwich -- бутерброд
satellite -- спутник
sauce -- соус, приправа, поливать соусом
sausage -- колбаса, сосиска
scare -- пугать
seldom -- редко
sell -- продавать
sell -- продавать, торговать
serve -- служить, обслуживать, подавать
service -- служба, сервис
settle -- поселить(ся), устраивать(ся)
several -- несколько
shake -- пожать (руки), дрожать, трясти
shame -- стыд, стыдить, стыдиться
shape -- форма
share -- часть, доля ("h" в середине есть)
share -- разделять, доля, часть
sharp -- резкий
sharp -- точно, ровно, резкий, крутой, плуто
shaver -- бритва
sheet -- простыня, лист
shift -- смена
shirt -- рубашка (мужская)
shoe -- ботинок
shot -- выстрел
shout -- крик, кричать
shrug -- пожимать (плечами)
shut -- закрывать(ся)
sick -- больной
sigh -- вздох
sight -- зрение, вид, взгляд
signature -- подпись
silence -- молчание, тишина
silk -- шелковый, шелк
silly -- глупый
silver -- серебро, серебряный
sing -- петь
single -- один, единственный; отдельный; один
sink -- тонуть, погружаться
skill -- мастерство
skin -- кожа
skirt -- юбка
sky -- небо
slack -- ленивый, слабый, ослаблять, утихать
slam -- со стуком (шумом) закрыть, захлопну
slightly -- слегка, едва
slip -- скольжение, ошибка
slumber -- сон, дремота, дремать
smell -- нюхать, пахнуть
snack -- закуска
snap -- треск
soap -- мыло
society -- общество
sock -- носок
softly -- мягко (не gently)
soon -- скоро, рано
sore -- больной, воспаленный (не sick)
spare -- уделять, лишний, запасный
spend -- тратить
spin -- вертеться, вращение
splendid -- замечательно
spoon -- ложка
sportsfan -- болельщик
spot -- пятно
spread -- распространять(ся)
stage -- сцена
stage -- сцена, эстрада, ставить
stair -- ступенька
star -- звезда, судьба, рок
stay -- оставаться, жить (временно)
steal -- красть
steel -- сталь
stewardess -- стюардесса
stick -- палка
stick -- палка, приставать
stocking -- чулок
stolen -- украденный (от steal)
stomach -- живот, желудок
storey -- этаж
stove -- печь, плита
straight -- прямой, честный
strange -- чужой 
straw -- пустяк, мелочь
stretch -- растягивать(ся)
strike -- бастовать
string -- вереница, ряд, струна, связывать
stroll -- прогулка, гулять
struggle -- борьба
subscription -- подписка
suburb -- пригород, окраина
suburbs -- окрестности
sudden -- внезапный
suggest -- предлагать, советовать
suit -- удовлетворять требованиям
suitable -- подходящий, соответствующий (не eli
suitcase -- чемодан
suite -- номер люкс
sunbathe -- загорать
superb -- превосходный
supper -- ужин
suppose -- полагать, предполагать
supreme -- верховный, высший
surrender -- сдаваться, уступать
suspect -- подозревать
swallow -- глотать, проглатывать
sweat -- пот, потеть
sweat -- пот, потеть
sweater -- свитер
sweep -- мести
sweep -- мести, подмести (не broom)
swell -- отличный, превосходный
swing -- качание, качели, качаться, колебать
switch -- выключатель
sympathy -- симпатия, сострадание
tablet -- таблетка
tack -- линия, курс
tailor -- портной
tape -- лента, записывать
team -- команда
teeth -- зубы
temper -- сдержанность, самообладание
textiles -- ткани
the last straw -- последняя капля (3 слова)
thick -- толстый
thick -- толстый, густой
thin -- тонкий, худой, редкий
thirsty -- испытывающий жажду
thought -- мысль, размышление
thrice -- трижды
throat -- горло
throat -- горло
through -- через, сквозь
tidy -- чистый, аккуратный, убирать, привод
tie -- соединение, лента, шнур
tie -- связь, связывать, галстук
tight -- туго
tight -- плотный, крепкий, тугой
till -- до
tiny -- крошечный
tip -- чаевые, давать на "чай", наконечник
tire -- уставать
tire -- уставать, надоесть
together -- вместе, одновременно
ton -- тонна
tongue -- язык
tonight -- сегодня вечером
tonight -- сегодня вечером
toothache -- зубная боль
toss -- бросать
toss -- толчок, сотрясение, кидать, бросать
touch -- соприкосновение, контакт
tough -- жесткий
tough -- жесткий
towel -- полотенце
tower -- башня
trade -- торговать, ремесло, занятие, профес
traffic -- уличное движение
tram -- трамвай
translate -- переводить, объяснять
travel -- путешествие
travel -- путешествовать
treat -- удовольствие, лечить, относиться
trial -- попытка, испытание
trip -- поездка, путешествие
trip -- поездка, экскурсия
trouble -- неприятность, беда, беспокоиться, в
trousers -- брюки
trout -- форель
truck -- грузовик (не lorry)
trust -- доверие, верить
truth -- правда, истина
turkey -- индейка
twist -- изгиб, вертеться
tyre -- шина
umbrella -- зонт
underwear -- нижнее белье
undress -- раздеваться
unforgettable -- незабываемый
union -- союз
unlikely -- маловероятный, вряд ли
unlucky -- неудачный
unskilled -- неквалифицированный
unusual -- необычный
upon -- на
upset -- беспорядок, расстройство, расстроен
utter -- издавать (звук), произносить
vacation -- отпуск, каникулы
vain -- напрасный, тщетный
veal -- телятина 
velocity -- скорость
venture -- предприятие, риск
verb -- глагол
vexed -- сердил, раздражал
via -- через
victory -- победа
wave -- волна, взмах
weapon -- оружие
wear -- одежда, носить, быть одетым
weekend -- выходные
weigh -- взвешивать, весить
weight -- вес, тяжесть, груз
well -- хорошо, очень, добро, здоровый
wet -- мокрый
wet -- мокрый
whatever -- любой; все, что
whether -- ли
whisper -- шепот, шептать
whistle -- свистеть, доносить
whose -- чей
widely -- широко
widow -- вдова
widower -- вдовец
wife -- жена
wild -- дикий, бешеный
wild -- исступленный, безумный
willingly -- охотно
wind -- ветер
windfall -- неожиданная удача
wing -- крыло самолета
wipe -- вытирать
wire -- проволока
wise -- мудрый
withdraw -- брать назад, забирать
wonder -- удивляться
woolen -- шерстяной
worse -- худший (не worst)
wound -- рана
wrap -- обертывать
yard -- двор
yell -- крик, кричать
able -- способный, умелый
abroad -- за границей
absence -- отсутствие
absolve -- прощать, оправдывать (не forgive)
abundance -- богатство, изобилие
accelerate -- ускорять(ся)
accent -- подчеркивать, произносить
accident -- несчастный случай
accidentally -- случайно, нечаянно
accommodate -- согласовывать, улаживать, примирять
accommodate -- согласовывать, улаживать, примирять
accompany -- сопровождать
accompany -- сопровождать
accord -- согласие, гармония
accord -- согласие, гармония
account -- счет, оценка, причина
accuracy -- точность, аккуратность
achieve -- достигать, успешно выполнять
acknowledge -- признавать, вознаграждать
acquaint -- знакомить
acquaintance -- знакомство, знакомый
across -- через
action -- действие
activity -- деятельность, активность
adamant -- алмаз, твердый, непреклонный (не di
adapt -- приспособить, переделать
adept -- знаток, сторонник
admiration -- восхищение
admit -- допускать
advanced -- передовой
advantage -- преимущество, выгода
aerophone -- радиотелефон
affability -- любезность, вежливость
affair -- дело, занятие
affectionate -- любящий, нежный
after all -- в конце концов (2 слова)
afterwards -- впоследствии, позже
agent -- деятель, исполнитель
aggrieve -- обижать, огорчать
agitation -- дискуссия, обсуждение (не агитация)
agriculture -- сельское хозяйство
ahead -- вперед (не forth)
aid -- помощь
alive -- живой
allow -- позволять
among -- среди
angle -- угол
angry -- сердитый
anyway -- в любом случае
approach -- приближение
arrive -- прибывать
ass -- осел
aunt -- тетя
avoid -- избегать, избежать
awake -- бодрствующий
award -- присуждать что-либо
aware -- сознающий
awful -- ужасный
backward -- назад, обратно, наоборот
badge -- знак, символ, эмблема
balance -- равновесие
ball -- шар, мяч
banner -- знамя
bare -- обнаженный
barely -- только, едва, лишь
bargain -- сделка
beach -- пляж; взморье
beam -- сияние
bear -- мишка
belt -- пояс, ремень
bend -- гнуться, сгибаться
beneath -- ниже, внизу
beside -- рядом с, около
beyond -- вдали
bit -- немного, кусочек
bite -- кусать(ся), жалить
blade -- лезвие
blow -- дуть
boat -- лодка, судно
bone -- кость, останки
bother -- беспокойство
brain -- мозг, ум
bright -- яркий, светлый
buddy -- приятель
bullet -- пуля
burn -- жечь, гореть
burst -- взрываться, лопаться
button -- пуговица, кнопка
calm -- тихий, успокаивать
cause -- причина
ceiling -- потолок
cell -- камера, карцер, ячейка
certainly -- конечно
chance -- возможность, шанс
cheek -- щека, наглость
chest -- грудная клетка
chief -- глава, главный
circle -- круг, окружность
click -- щелкать
climb -- подниматься (на) (среди них есть "b
clothes -- одежда
cloud -- облако, туча
coach -- тренер
coat -- пальто
colonel -- полковник
completely -- совершенно, полностью
concern -- отношение, иметь отношение (к) (не pertain)
conversation -- разговор, беседа
cool -- прохладный
cop -- полицейский
counter -- противоположный, противостоять
couple -- пара, два
crack -- треск
crawl -- ползание (не creep)
creature -- создание, тварь
crew -- экипаж (судна и т.п.)
crowd -- толпа
cruel -- жестокий, беспощадный
cruelty -- жестокость
crumb -- крошка
cry -- крик, кричать
cultivate -- обрабатывать
cupboard -- буфет
curds -- творог
cure -- лекарство, лечить (не drug)
curiosity -- любопытство, редкая вещь
curious -- любознательный
currency -- валюта$
curse -- проклятие
curtain -- занавеска, занавес
curve -- изгиб, гнуть
cushion -- подушка
custom -- обычай
customer -- клиент
customs -- таможня
cute -- изящный, прелестный
cutlet -- котлета
daily -- ежедневно
dainty -- лакомство, деликатес
dam -- дамба, плотина
dame -- дама, пожилая женщина (не lady)
damp -- сырой, влажный
dance -- танец
dancer -- танцор
dandy -- нарядный, великолепный
dare -- сметь, отважиться
darkness -- темнота
darkness -- темнота, мрак
darling -- любимый, дорогой
dash -- оттолкнуть, отбросить
dawn -- рассвет, светать
deaf -- глухой
deafen -- оглушить, заглушить
deal -- значительное количество
dean -- декан
dear -- дорогой
deathless -- бессмертный
debt -- долг
decent -- приличный, скромный
deception -- обман, хитрость
decide -- решать
deck -- палуба
deck -- палуба
decorate -- украшать
delight -- восхищение, восхищаться
delivery -- доставка
demand -- требовать
dentist -- зубной врач
departure -- отъезд, отправление
desert -- пустыня, покидать
desire -- (страстное) желание
destination -- место назначения
devil -- дьявол, сатана
dig -- копать
dinner -- обед
direct -- прямой, руководить
directory -- справочник
disadvantage -- неудобство
disagreement -- несогласие
disappoint -- разочаровывать
disapproval -- неодобрение
disbelief -- недоверие
discord -- разногласие, раздоры
discuss -- обсуждать
discussion -- беседа
disgraceful -- позорный
dish -- блюдо
district -- район
dive -- нырять
divorce -- развод
doll -- кукла
doorway -- дверной проем
doubt -- сомнение
drag -- тащить(ся)
drug -- лекарство (не cure)
dry -- сухой
dust -- пыль
ear -- ухо
earth -- земля
edge -- острие, лезвие
edgeway -- острие
editor -- редактор
either -- любой (из двух)
either -- или
embassy -- посольство
emergency -- крайняя необходимость
engage -- нанимать, занимать, вовлекать
engine -- двигатель, мотор
entire -- целый, полный, весь
entrance -- вход
escape -- побег
exactly -- точно
exactly -- точно, именно
exercise -- упражнение
exhausted -- изнуренный
exile -- ссылать, изгнание
expectancy -- ожидание, надежда
explain --  объяснять
explorer -- исследователь
extension -- расширение
extra -- сверх (не above)
extremely -- крайне
eyepencil -- карандаш для век
fable -- басня, сюжет
fabric -- ткань, материя, сооружение
fade -- вянуть, блекнуть
fade -- увядать
faint -- слабый
faint -- слабый
fairy tale -- сказка (2 слова, 5 букв и 4 буквы)
faith -- вера
faithful -- верный
faithless -- ненадежный
fit -- годный
flame -- пламя, сияние
flat -- квартира
flight -- полет, рейс
foot -- ступня, нога
force -- сила, насилие (не power)
frame -- каркас
frown -- хмуриться
fuck -- к черту (не shit)
fucking -- чертов, долбаный, трах-й (не от shit)
gate -- ворота
gather -- собирать(ся)
gaze -- пристальный взгляд
gently -- мягко, нежно (не softly)
gesture -- жест
ghost -- призрак, привидение
glow -- свет, сверкать
gotta -- должен, должна (разговорное)
grace -- грация, изящество
grand -- грандиозный, большой, важный (не la
grandchildren -- внуки
grapes -- виноград
grasp -- понять, схватить
grin -- усмешка, ухмыляться
grip -- сжатие, хватка
hall -- зал, передняя, холл
hallway -- прихожая
handle -- ручка, рукоятка, удобный случай, во
hanger -- крюк, вешалка
harm -- беда, неприятность
hat -- шляпа
hat -- шляпа
hate -- ненавидеть
headache -- головная боль
headphones -- наушники
heart -- сердце
heater -- нагреватель
heaven -- небо, небеса, бог, провидение
heavy -- тяжелый
heavy -- тяжелый
hell -- черт
herring -- сельдь 
hiking -- пеший поход
hill -- холм
hit -- успех, удача, попадать в цель
hockey -- хоккей
hold -- держать(ся), выдерживать, захват, в
hole -- дыра
hope -- надеяться
horse -- конь
hose -- чулки
hospitality -- гостеприимство
host -- хозяин
hurry -- спешка, спешить
hurt -- ушибить, болеть, причинять боль
husband -- муж
ignorance -- незнание, невежество
ill -- больной
imagine -- воображать
immediately -- немедленно
in vain -- напрасно (2 слова)
income -- доход, заработок
incomprehension -- непонимание
instead -- вместо
island -- остров
jacket -- куртка, пиджак
join -- соединять(ся)
judge -- судья
knee -- колено
knee -- колено
knife -- нож
knitted -- вязанный, трикотажный
knock -- стук, удар
lamb -- ягненок, баранина
land -- земля, суша, приземляться, высажива
lark -- шутка, забава (не joke)
laundry -- прачечная, стирка
lawyer -- адвокат
lay -- класть, положить (не put)
leap -- прыгать, скакать
leap -- високосный, прыжок, прыгать
least -- наименьший
leather -- кожа, кожаный
leave -- оставлять, покидать, уезжать
leisure -- досуг
lend -- дать в долг
lip -- губа
load -- груз, грузить
loose -- свободный
loud -- громко
manage -- руководить
mark -- знак, оценка
marry -- жениться, выходить замуж
massage -- массаж
masterpiece -- шедевр
match -- спичка
matinees -- утренние спектакли
matter -- дело, сущность, материал
meal -- еда, есть, принимать пищу
means -- средство, способ
melon -- дыня
mend -- чинить, ремонтировать
mention -- упоминание
mention -- благодарность, упоминать
merry -- веселый, радостный (не jolly, funny)
metal -- металл, металлический
meter -- счетчик
middle -- средний
mild -- мягкий (не soft)
miracle -- чудо
mistrust -- недоверие, подозрение
motion -- движение
mountain -- гора
movie -- кино, фильм
narrow -- узкий
nearly -- почти, около (не almost)
neither -- ни тот, ни другой
nicest -- самый вкусный
noisy -- шумный
nonsense -- чепуха, ерунда (не bullshit)
noon -- полдень
nose -- нос, обоняние
note -- заметка
notice -- извещение, сообщение, уведомление
nowadays -- в наше время
numerous -- многочисленный
nurse -- няня, сиделка
nurse -- няня
oar -- весло
offer -- предложение, предлагать
ointment -- мазь
omelette -- омлет
onion -- лук
opinion -- мнение
option -- выбор (последняя буква n)
ordinal -- порядковый
pain -- боль
pair -- пара
pale -- бледный
party -- вечеринка, группа
pass -- передавать, проходить, пропуск, пер
pate -- паштет
path -- тропинка, путь
perfect -- совершенный
piece -- кусок
pin -- булавка, значок, прикалывать
pineapple -- ананас
pity -- жалость
place -- место
plain -- ясный, очевидный, равнина
plane -- плоскость, самолет
plate -- тарелка
plate -- тарелка
pleasant -- приятный
pleasure -- удовольствие
plum -- слива
pocket -- карман, мешок
poem -- стихотворение, поэма
polish -- лак
polite -- любезный, вежливый
pollution -- загрязнение
pool -- пруд, бассейн
poor -- бедный, несчастный
poor -- бедный
pork -- свинина
porridge -- каша
porter -- носильщик
postcard -- почтовая открытка
potato -- картофель
pour -- лить(ся), наливать
powder -- пудра
praise -- хвалить
prefer -- предпочитать
prepare -- готовить(ся)
prescription -- рецепт
pretty -- хорошенький
private -- рядовой
probability -- вероятность
probably -- вероятно
promise -- обещание
pyjamas -- пижама
quarrel -- ссора, ссориться
questionable -- сомнительный
quiet -- спокойный (не still)
quite -- вполне, совсем
quivering -- дрожащий
rate -- тариф, расценка, степень
rather -- скорее, лучше
ray -- луч
razor -- бритва
ready -- готовый$
rear -- задняя сторона, тыл
rear -- задняя часть
recall -- припомнить, отозвать
receipt -- квитанция
reception -- прием
recover -- выздоравливать
recovery -- выздоровление
reduce -- уменьшать, понижать, сокращать
reference -- рекомендация, ссылка, справка
refreshments -- закуски и напитки
refrigerator -- холодильник
refuse -- отказывать
regards -- привет, поклон
relation -- отношение, связь
relationship -- родственные связи
rely -- полагаться, доверять
remain -- оставаться
remember -- помнить
remote -- дистанционный, удаленный
rent -- брать напрокат, снимать жилье, квар
repair -- ремонтировать, ремонт, починка
request -- просьба
research -- исследование
resident -- постоянный житель
respect -- уважение, уважать
restriction -- ограничение
reveal -- открывать, разоблачать, обнаруживат
ride -- ехать (верхом)
rifle -- винтовка
rip -- разрез, разрыв
roar -- рев, грохот
rock -- камень, скала
roof -- крыша
rot -- вздор, нелепость
route -- маршрут, путь, направлять
rowing -- гребля, выговор
rude -- грубый, резкий, невоспитанный
rush -- спешка, бросаться
sad -- печальный
safe -- безопасный
sail -- парус, плыть
sailor -- матрос
sake -- ради, для
salmon -- лосось
sandwich -- бутерброд
satellite -- спутник$
sauce -- соус, приправа, поливать соусом
sausage -- колбаса, сосиска
scare -- пугать
seldom -- редко
sell -- продавать
sell -- продавать, торговать
serve -- служить, обслуживать, подавать
service -- служба, сервис
settle -- поселить(ся), устраивать(ся)
several -- несколько
shake -- пожать (руки), дрожать, трясти
shame -- стыд, стыдить, стыдиться
shape -- форма
share -- часть, доля ("h" в середине есть)
share -- разделять, доля, часть
sharp -- резкий
sharp -- точно, ровно, резкий, крутой, плуто
shaver -- бритва
sheet -- простыня, лист
shift -- смена
shirt -- рубашка (мужская)
shoe -- ботинок
shot -- выстрел
shout -- крик, кричать
shrug -- пожимать (плечами)
shut -- закрывать(ся)
sick -- больной
sigh -- вздох
sight -- зрение, вид, взгляд
signature -- подпись
silence -- молчание, тишина
silk -- шелковый, шелк
silly -- глупый
silver -- серебро, серебряный
sing -- петь
single -- один, единственный; отдельный; один
sink -- тонуть, погружаться
skill -- мастерство
skin -- кожа
skirt -- юбка
sky -- небо
slack -- ленивый, слабый, ослаблять, утихать
slam -- со стуком (шумом) закрыть, захлопну
slightly -- слегка, едва
slip -- скольжение, ошибка
slumber -- сон, дремота, дремать
smell -- нюхать, пахнуть
snack -- закуска
snap -- треск
soap -- мыло
society -- общество
sock -- носок
softly -- мягко (не gently)
soon -- скоро, рано
sore -- больной, воспаленный (не sick)
spare -- уделять, лишний, запасный
spend -- тратить
spin -- вертеться, вращение
splendid -- замечательно
spoon -- ложка
sportsfan -- болельщик
spot -- пятно
spread -- распространять(ся)
stage -- сцена
stage -- сцена, эстрада, ставить
stair -- ступенька
star -- звезда, судьба, рок
stay -- оставаться, жить (временно)$
steal -- красть
steel -- сталь
stewardess -- стюардесса
stick -- палка
stick -- палка, приставать
stocking -- чулок
stolen -- украденный (от steal)
stomach -- живот, желудок
storey -- этаж
stove -- печь, плита
straight -- прямой, честный
strange -- чужой 
straw -- пустяк, мелочь
stretch -- растягивать(ся)
strike -- бастовать
string -- вереница, ряд, струна, связывать
stroll -- прогулка, гулять
struggle -- борьба
subscription -- подписка
suburb -- пригород, окраина
suburbs -- окрестности
sudden -- внезапный
suggest -- предлагать, советовать
suit -- удовлетворять требованиям
suitable -- подходящий, соответствующий (не eli
suitcase -- чемодан
suite -- номер люкс
sunbathe -- загорать
superb -- превосходный
supper -- ужин
suppose -- полагать, предполагать
supreme -- верховный, высший
surrender -- сдаваться, уступать
suspect -- подозревать
swallow -- глотать, проглатывать
sweat -- пот, потеть
sweat -- пот, потеть
sweater -- свитер
sweep -- мести
sweep -- мести, подмести (не broom)
swell -- отличный, превосходный
swing -- качание, качели, качаться, колебать
switch -- выключатель
sympathy -- симпатия, сострадание
tablet -- таблетка
tack -- линия, курс
tailor -- портной
tape -- лента, записывать
team -- команда
teeth -- зубы
temper -- сдержанность, самообладание
textiles -- ткани
the last straw -- последняя капля (3 слова)
thick -- толстый
thick -- толстый, густой
thin -- тонкий, худой, редкий
thirsty -- испытывающий жажду
thought -- мысль, размышление
thrice -- трижды
throat -- горло$
throat -- горло
through -- через, сквозь
tidy -- чистый, аккуратный, убирать, привод
tie -- соединение, лента, шнур
tie -- связь, связывать, галстук
tight -- туго
tight -- плотный, крепкий, тугой
till -- до
tiny -- крошечный
tip -- чаевые, давать на "чай", наконечник
tire -- уставать
tire -- уставать, надоесть
together -- вместе, одновременно
ton -- тонна
tongue -- язык
tonight -- сегодня вечером
tonight -- сегодня вечером
toothache -- зубная боль
toss -- бросать
toss -- толчок, сотрясение, кидать, бросать
touch -- соприкосновение, контакт
tough -- жесткий
tough -- жесткий
towel -- полотенце
tower -- башня
trade -- торговать, ремесло, занятие, профес
traffic -- уличное движение
tram -- трамвай
translate -- переводить, объяснять
travel -- путешествие
travel -- путешествовать
treat -- удовольствие, лечить, относиться
trial -- попытка, испытание
trip -- поездка, путешествие
trip -- поездка, экскурсия
trouble -- неприятность, беда, беспокоиться, в
trousers -- брюки
trout -- форель
truck -- грузовик (не lorry)
trust -- доверие, верить
truth -- правда, истина
turkey -- индейка
twist -- изгиб, вертеться
tyre -- шина
umbrella -- зонт
underwear -- нижнее белье
undress -- раздеваться
unforgettable -- незабываемый
union -- союз
unlikely -- маловероятный, вряд ли
unlucky -- неудачный
unskilled -- неквалифицированный
unusual -- необычный
upon -- на
upset -- беспорядок, расстройство, расстроен
utter -- издавать (звук), произносить
vacation -- отпуск, каникулы
vain -- напрасный, тщетный
veal -- телятина 
velocity -- скорость
venture -- предприятие, риск
verb -- глагол
vexed -- сердил, раздражал
via -- через
victory -- победа
wave -- волна, взмах
weapon -- оружие
wear -- одежда, носить, быть одетым
weekend -- выходные
